ABERRATION 	AE B ER EY SH AH N 	ae b E R e I S 2 n 
ABILITY 	AH B IH L AH T IY 	2 b I l 2 t i 
ABOMINATION 	AH B AA M AH N EY SH AH N 	2 b a m 2 n e I S 2 n 
ABOVE 	AH B AH V 	2 b 2 v 
ABSENCE 	AE B S AH N S 	ae b s 2 n s 
ABSORPTION 	AH B Z AO R P SH AH N 	2 b z O r p S 2 n 
ABSTINENCE 	AE B S T AH N AH N S 	ae b s t 2 n 2 n s 
ABSTRACTION 	AE B S T R AE K SH AH N 	ae b s t r ae k S 2 n 
ABSURDITY 	AH B S ER D AH T IY 	2 b s E R d 2 t i 
ABUNDANCE 	AH B AH N D AH N S 	2 b 2 n d 2 n s 
ABUSE 	AH B Y UW S 	2 b j u s 
ABUSER 	AH B Y UW Z ER 	2 b j u z E R 
ABYSS 	AH B IH S 	2 b I s 
ACCENT 	AH K S EH N T 	2 k s E n t 
ACCEPTANCE 	AE K S EH P T AH N S 	ae k s E p t 2 n s 
ACCESS 	AE K S EH S 	ae k s E s 
ACCESSIBILITY 	AE K S EH S AH B IH L IH T IY 	ae k s E s 2 b I l I t i 
ACCESSORY 	AE K S EH S ER IY 	ae k s E s E R i 
ACCIDENT 	AE K S AH D AH N T 	ae k s 2 d 2 n t 
ACCOMMODATION 	AH K AA M AH D EY SH AH N 	2 k a m 2 d e I S 2 n 
ACCOMPLICE 	AH K AA M P L AH S 	2 k a m p l 2 s 
ACCOMPLISHMENT 	AH K AA M P L IH SH M AH N T 	2 k a m p l I S m 2 n t 
ACCORD 	AH K AO R D 	2 k O r d 
ACCOUNT 	AH K AW N T 	2 k E U n t 
ACCOUNTABILITY 	AH K AW N T AH B IH L IH T IY 	2 k E U n t 2 b I l I t i 
ACCOUNTANT 	AH K AW N T AH N T 	2 k E U n t 2 n t 
ACCOUNTING 	AH K AW N T IH NG 	2 k E U n t I N 
ACCUMULATION 	AH K Y UW M Y AH L EY SH AH N 	2 k j u m j 2 l e I S 2 n 
ACCURACY 	AE K Y ER AH S IY 	ae k j E R 2 s i 
ACHIEVEMENT 	AH CH IY V M AH N T 	2 tS i v m 2 n t 
ACIDITY 	AH S IH D AH T IY 	2 s I d 2 t i 
ACQUAINTANCE 	AH K W EY N T AH N S 	2 k w e I n t 2 n s 
ACQUISITION 	AE K W AH Z IH SH AH N 	ae k w 2 z I S 2 n 
ACRONYM 	AE K R AH N IH M 	ae k r 2 n I m 
ACT 	AE K T 	ae k t 
ACTION 	AE K SH AH N 	ae k S 2 n 
ACTIVIST 	AE K T IH V IH S T 	ae k t I v I s t 
ACTIVITY 	AE K T IH V IH T IY 	ae k t I v I t i 
ACTRESS 	AE K T R AH S 	ae k t r 2 s 
ACUPUNCTURE 	AE K Y UW P AH NG K CH ER 	ae k j u p 2 N k tS E R 
ACUPUNCTURIST 	AE K Y AH P AH NG K T Y AH R AH S T 	ae k j 2 p 2 N k t j 2 r 2 s t 
ADAPTATION 	AE D AH P T EY SH AH N 	ae d 2 p t e I S 2 n 
ADDENDUM 	AH D EH N D AH M 	2 d E n d 2 m 
ADDICT 	AH D IH K T 	2 d I k t 
ADDICTION 	AH D IH K SH AH N 	2 d I k S 2 n 
ADDITION 	AH D IH SH AH N 	2 d I S 2 n 
ADDITIVE 	AE D IH T IH V 	ae d I t I v 
ADDRESS 	AE D R EH S 	ae d r E s 
ADHERENT 	AH D HH IH R AH N T 	2 d h I r 2 n t 
ADJUSTMENT 	AH JH AH S T M AH N T 	2 dZ 2 s t m 2 n t 
ADMINISTRATION 	AE D M IH N IH S T R EY SH AH N 	ae d m I n I s t r e I S 2 n 
ADMINISTRATOR 	AH D M IH N IH S T R EY T ER 	2 d m I n I s t r e I t E R 
ADMIRATION 	AE D M ER EY SH AH N 	ae d m E R e I S 2 n 
ADMISSION 	AE D M IH SH AH N 	ae d m I S 2 n 
ADOLESCENT 	AE D AH L EH S AH N T 	ae d 2 l E s 2 n t 
ADOPTION 	AH D AA P SH AH N 	2 d a p S 2 n 
ADULT 	AH D AH L T 	2 d 2 l t 
ADVANCE 	AH D V AE N S 	2 d v ae n s 
ADVANCEMENT 	AH D V AE N S M AH N T 	2 d v ae n s m 2 n t 
ADVANTAGE 	AE D V AE N T IH JH 	ae d v ae n t I dZ 
ADVENTURE 	AE D V EH N CH ER 	ae d v E n tS E R 
ADVERT 	AE D V ER T 	ae d v E R t 
ADVERTISING 	AE D V ER T AY Z IH NG 	ae d v E R t E I z I N 
ADVICE 	AE D V AY S 	ae d v E I s 
ADVISE 	AE D V AY Z 	ae d v E I z 
ADVISER 	AE D V AY Z ER 	ae d v E I z E R 
ADVISOR 	AE D V AY Z ER 	ae d v E I z E R 
ADVOCATE 	AE D V AH K AH T 	ae d v 2 k 2 t 
AFFAIR 	AH F EH R 	2 f E r 
AFFECTATION 	AE F EH K T EY SH AH N 	ae f E k t e I S 2 n 
AFFECTION 	AH F EH K SH AH N 	2 f E k S 2 n 
AFFILIATE 	AH F IH L IY EY T 	2 f I l i e I t 
AFFINITY 	AH F IH N IH T IY 	2 f I n I t i 
AFICIONADO 	AH F IY SH Y AH N AA D OW 	2 f i S j 2 n a d o U 
AFTERMATH 	AE F T ER M AE TH 	ae f t E R m ae T 
AFTERNOON 	AE F T ER N UW N 	ae f t E R n u n 
AFTERSHOCK 	AE F T ER SH AA K 	ae f t E R S a k 
AGE 	EY JH 	e I dZ 
AGENCY 	EY JH AH N S IY 	e I dZ 2 n s i 
AGENDA 	AH JH EH N D AH 	2 dZ E n d 2 
AGENT 	EY JH AH N T 	e I dZ 2 n t 
AGGRAVATION 	AE G R AH V EY SH AH N 	ae g r 2 v e I S 2 n 
AGGREGATION 	AE G R AH G EY SH AH N 	ae g r 2 g e I S 2 n 
AGGRESSION 	AH G R EH SH AH N 	2 g r E S 2 n 
AGREEMENT 	AH G R IY M AH N T 	2 g r i m 2 n t 
AHEAD 	AH HH EH D 	2 h E d 
AID 	EY D 	e I d 
AILMENT 	EY L M AH N T 	e I l m 2 n t 
AIM 	EY M 	e I m 
AIR 	EH R 	E r 
AIRCRAFT 	EH R K R AE F T 	E r k r ae f t 
AIRFARE 	EH R F EH R 	E r f E r 
AIRLIFT 	EH R L IH F T 	E r l I f t 
AIRLINE 	EH R L AY N 	E r l E I n 
AIRLINER 	EH R L AY N ER 	E r l E I n E R 
AIRPLANE 	EH R P L EY N 	E r p l e I n 
AIRPORT 	EH R P AO R T 	E r p O r t 
AIRWAY 	EH R W EY 	E r w e I 
ALARM 	AH L AA R M 	2 l a r m 
ALCOHOL 	AE L K AH HH AA L 	ae l k 2 h a l 
ALCOHOLISM 	AE L K AH HH AO L IH Z AH M 	ae l k 2 h O l I z 2 m 
ALE 	EY L 	e I l 
ALERT 	AH L ER T 	2 l E R t 
ALGA 	AE L G AH 	ae l g 2 
ALIAS 	EY L IY AH S 	e I l i 2 s 
ALIGNMENT 	AH L AY N M AH N T 	2 l E I n m 2 n t 
ALL 	AO L 	O l 
ALLEGATION 	AE L AH G EY SH AH N 	ae l 2 g e I S 2 n 
ALLIANCE 	AH L AY AH N S 	2 l E I 2 n s 
ALLOCATION 	AE L AH K EY SH AH N 	ae l 2 k e I S 2 n 
ALLOWANCE 	AH L AW AH N S 	2 l E U 2 n s 
ALLY 	AE L AY 	ae l E I 
ALTAR 	AO L T ER 	O l t E R 
ALTERATION 	AO L T ER EY SH AH N 	O l t E R e I S 2 n 
ALTERNATE 	AO L T ER N AH T 	O l t E R n 2 t 
ALTERNATIVE 	AO L T ER N AH T IH V 	O l t E R n 2 t I v 
ALTITUDE 	AE L T AH T UW D 	ae l t 2 t u d 
ALUMINUM 	AH L UW M AH N AH M 	2 l u m 2 n 2 m 
AMALGAM 	AH M AE L G AH M 	2 m ae l g 2 m 
AMBASSADOR 	AE M B AE S AH D ER 	ae m b ae s 2 d E R 
AMBIANCE 	AE M B IY AH N S 	ae m b i 2 n s 
AMBITION 	AE M B IH SH AH N 	ae m b I S 2 n 
AMBULANCE 	AE M B Y AH L AH N S 	ae m b j 2 l 2 n s 
AMENDED 	AH M EH N D IH D 	2 m E n d I d 
AMENDMENT 	AH M EH N D M AH N T 	2 m E n d m 2 n t 
AMMONIA 	AH M OW N Y AH 	2 m o U n j 2 
AMMUNITION 	AE M Y AH N IH SH AH N 	ae m j 2 n I S 2 n 
AMNESTY 	AE M N AH S T IY 	ae m n 2 s t i 
AMOUNT 	AH M AW N T 	2 m E U n t 
AMUSE 	AH M Y UW Z 	2 m j u z 
AMUSEMENT 	AH M Y UW Z M AH N T 	2 m j u z m 2 n t 
ANALYSIS 	AE N AE L IH S IH S 	ae n ae l I s I s 
ANALYST 	AE N AH L IH S T 	ae n 2 l I s t 
ANESTHETIC 	AE N AH S TH EH T IH K 	ae n 2 s T E t I k 
ANGEL 	EY N JH AH L 	e I n dZ 2 l 
ANGER 	AE NG G ER 	ae N g E R 
ANGLE 	AE NG G AH L 	ae N g 2 l 
ANIMAL 	AE N AH M AH L 	ae n 2 m 2 l 
ANNEX 	AE N EH K S 	ae n E k s 
ANNEXATION 	AE N EH K S EY SH AH N 	ae n E k s e I S 2 n 
ANNIVERSARY 	AE N AH V ER S ER IY 	ae n 2 v E R s E R i 
ANNOUNCEMENT 	AH N AW N S M EH N T 	2 n E U n s m E n t 
ANSWER 	AE N S ER 	ae n s E R 
ANT 	AE N T 	ae n t 
ANTHRAX 	AE N TH R AE K S 	ae n T r ae k s 
ANTIBIOTIC 	AE N T IY B AY AA T IH K 	ae n t i b E I a t I k 
ANTIPASTO 	AE N T AH P AE S T OW 	ae n t 2 p ae s t o U 
ANTIQUE 	AE N T IY K 	ae n t i k 
ANTIQUITY 	AE N T IH K W AH T IY 	ae n t I k w 2 t i 
ANYTIME 	EH N IY T AY M 	E n i t E I m 
ANYWHERE 	EH N IY W EH R 	E n i w E r 
APARTMENT 	AH P AA R T M AH N T 	2 p a r t m 2 n t 
APERTURE 	AE P ER CH ER 	ae p E R tS E R 
APOGEE 	AE P AH JH IY 	ae p 2 dZ i 
APOLOGY 	AH P AA L AH JH IY 	2 p a l 2 dZ i 
APPARATUS 	AE P ER AE T AH S 	ae p E R ae t 2 s 
APPEAL 	AH P IY L 	2 p i l 
APPEARANCE 	AH P IH R AH N S 	2 p I r 2 n s 
APPELLATION 	AE P AH L EY SH AH N 	ae p 2 l e I S 2 n 
APPENDIX 	AH P EH N D IH K S 	2 p E n d I k s 
APPETITE 	AE P AH T AY T 	ae p 2 t E I t 
APPETIZER 	AE P AH T AY Z ER 	ae p 2 t E I z E R 
APPLIANCE 	AH P L AY AH N S 	2 p l E I 2 n s 
APPLICANT 	AE P L IH K AH N T 	ae p l I k 2 n t 
APPLICATION 	AE P L AH K EY SH AH N 	ae p l 2 k e I S 2 n 
APPOINTEE 	AH P OY N T IY 	2 p U I n t i 
APPOINTMENT 	AH P OY N T M AH N T 	2 p U I n t m 2 n t 
APPRECIATION 	AH P R IY SH IY EY SH AH N 	2 p r i S i e I S 2 n 
APPREHENSION 	AE P R IH HH EH N SH AH N 	ae p r I h E n S 2 n 
APPRENTICE 	AH P R EH N T AH S 	2 p r E n t 2 s 
APPROACH 	AH P R OW CH 	2 p r o U tS 
APPROPRIATION 	AH P R OW P R IY EY SH AH N 	2 p r o U p r i e I S 2 n 
APPROVAL 	AH P R UW V AH L 	2 p r u v 2 l 
APPROVED 	AH P R UW V D 	2 p r u v d 
APPROXIMATION 	AH P R AA K S AH M EY SH AH N 	2 p r a k s 2 m e I S 2 n 
APRON 	EY P R AH N 	e I p r 2 n 
AQUARIUM 	AH K W EH R IY AH M 	2 k w E r i 2 m 
ARBITRATION 	AA R B IH T R EY SH AH N 	a r b I t r e I S 2 n 
ARBITRATOR 	AA R B IH T R EY T ER 	a r b I t r e I t E R 
ARCHIPELAGO 	AA R K AH P EH L AH G OW 	a r k 2 p E l 2 g o U 
ARCHIVE 	AA R K AY V 	a r k E I v 
AREA 	EH R IY AH 	E r i 2 
ARENA 	ER IY N AH 	E R i n 2 
ARGUMENT 	AA R G Y AH M AH N T 	a r g j 2 m 2 n t 
ARM 	AA R M 	a r m 
ARMAMENT 	AA R M AH M AH N T 	a r m 2 m 2 n t 
ARMATURE 	AA R M AH CH ER 	a r m 2 tS E R 
ARMY 	AA R M IY 	a r m i 
AROUND 	ER AW N D 	E R E U n d 
ARRANGEMENT 	ER EY N JH M AH N T 	E R e I n dZ m 2 n t 
ARREST 	ER EH S T 	E R E s t 
ARRIVAL 	ER AY V AH L 	E R E I v 2 l 
ARROGANCE 	EH R AH G AH N S 	E r 2 g 2 n s 
ARSENAL 	AA R S AH N AH L 	a r s 2 n 2 l 
ARSENIC 	AA R S AH N IH K 	a r s 2 n I k 
ART 	AA R T 	a r t 
ARTERY 	AA R T ER IY 	a r t E R i 
ARTHRITIS 	AA R TH R AY T AH S 	a r T r E I t 2 s 
ARTICLE 	AA R T AH K AH L 	a r t 2 k 2 l 
ARTICULATING 	AA R T IH K Y AH L EY T IH NG 	a r t I k j 2 l e I t I N 
ARTILLERY 	AA R T IH L ER IY 	a r t I l E R i 
ARTIST 	AA R T AH S T 	a r t 2 s t 
ARTWORK 	AA R T W ER K 	a r t w E R k 
ASBESTOS 	AE S B EH S T AH S 	ae s b E s t 2 s 
ASPARAGUS 	AH S P EH R AH G AH S 	2 s p E r 2 g 2 s 
ASPECT 	AE S P EH K T 	ae s p E k t 
ASPEN 	AE S P AH N 	ae s p 2 n 
ASPIRATION 	AE S P ER EY SH AH N 	ae s p E R e I S 2 n 
ASPIRIN 	AE S P R IH N 	ae s p r I n 
ASS 	AE S 	ae s 
ASSAILANT 	AH S EY L AH N T 	2 s e I l 2 n t 
ASSASSIN 	AH S AE S AH N 	2 s ae s 2 n 
ASSASSINATION 	AH S AE S AH N EY SH AH N 	2 s ae s 2 n e I S 2 n 
ASSAULT 	AH S AO L T 	2 s O l t 
ASSEMBLY 	AH S EH M B L IY 	2 s E m b l i 
ASSERTION 	AH S ER SH AH N 	2 s E R S 2 n 
ASSESSMENT 	AH S EH S M AH N T 	2 s E s m 2 n t 
ASSET 	AE S EH T 	ae s E t 
ASSIGNMENT 	AH S AY N M AH N T 	2 s E I n m 2 n t 
ASSISTANCE 	AH S IH S T AH N S 	2 s I s t 2 n s 
ASSISTANT 	AH S IH S T AH N T 	2 s I s t 2 n t 
ASSOCIATE 	AH S OW S IY AH T 	2 s o U s i 2 t 
ASSOCIATION 	AH S OW S IY EY SH AH N 	2 s o U s i e I S 2 n 
ASSORTMENT 	AH S AO R T M AH N T 	2 s O r t m 2 n t 
ASSUMPTION 	AH S AH M P SH AH N 	2 s 2 m p S 2 n 
ASSURANCE 	AH SH UH R AH N S 	2 S U r 2 n s 
ASTRONAUT 	AE S T R AH N AA T 	ae s t r 2 n a t 
ASTRONOMY 	AH S T R AA N AH M IY 	2 s t r a n 2 m i 
ATMOSPHERE 	AE T M AH S F IH R 	ae t m 2 s f I r 
ATROCITY 	AH T R AA S AH T IY 	2 t r a s 2 t i 
ATROPHY 	AE T R AH F IY 	ae t r 2 f i 
ATTACHMENT 	AH T AE CH M AH N T 	2 t ae tS m 2 n t 
ATTACK 	AH T AE K 	2 t ae k 
ATTEMPT 	AH T EH M P T 	2 t E m p t 
ATTENDANCE 	AH T EH N D AH N S 	2 t E n d 2 n s 
ATTENDANT 	AH T EH N D AH N T 	2 t E n d 2 n t 
ATTENTION 	AH T EH N SH AH N 	2 t E n S 2 n 
ATTITUDE 	AE T AH T UW D 	ae t 2 t u d 
ATTORNEY 	AH T ER N IY 	2 t E R n i 
ATTRACTION 	AH T R AE K SH AH N 	2 t r ae k S 2 n 
AUCTION 	AA K SH AH N 	a k S 2 n 
AUDACITY 	AA D AE S AH T IY 	a d ae s 2 t i 
AUDIENCE 	AA D IY AH N S 	a d i 2 n s 
AUDIO 	AA D IY OW 	a d i o U 
AUDIT 	AO D IH T 	O d I t 
AUNT 	AE N T 	ae n t 
AUSPICES 	AO S P IH S IH Z 	O s p I s I z 
AUTHOR 	AO TH ER 	O T E R 
AUTHORITY 	AH TH AO R AH T IY 	2 T O r 2 t i 
AUTHORIZATION 	AO TH ER AH Z EY SH AH N 	O T E R 2 z e I S 2 n 
AUTO 	AO T OW 	O t o U 
AUTONOMY 	AO T AA N AH M IY 	O t a n 2 m i 
AUTUMN 	AO T AH M 	O t 2 m 
AVAIL 	AH V EY L 	2 v e I l 
AVAILABILITY 	AH V EY L AH B IH L AH T IY 	2 v e I l 2 b I l 2 t i 
AVENGER 	AH V EH N JH ER 	2 v E n dZ E R 
AVERAGE 	AE V ER IH JH 	ae v E R I dZ 
AVERSION 	AH V ER ZH AH N 	2 v E R Z 2 n 
AVIATION 	EY V IY EY SH AH N 	e I v i e I S 2 n 
AVOIDANCE 	AH V OY D AH N S 	2 v U I d 2 n s 
AWARD 	AH W AO R D 	2 w O r d 
AWARENESS 	AH W EH R N AH S 	2 w E r n 2 s 
AWAY 	AH W EY 	2 w e I 
BABY 	B EY B IY 	b e I b i 
BACHELOR 	B AE CH AH L ER 	b ae tS 2 l E R 
BACK 	B AE K 	b ae k 
BACKGROUND 	B AE K G R AW N D 	b ae k g r E U n d 
BACKPACK 	B AE K P AE K 	b ae k p ae k 
BACKSIDE 	B AE K S AY D 	b ae k s E I d 
BACKUP 	B AE K AH P 	b ae k 2 p 
BACTERIOLOGIST 	B AE K T AH R IY AA L AH JH AH S T 	b ae k t 2 r i a l 2 dZ 2 s t 
BAD 	B AE D 	b ae d 
BADGE 	B AE JH 	b ae dZ 
BAG 	B AE G 	b ae g 
BAGEL 	B EY G AH L 	b e I g 2 l 
BAGGAGE 	B AE G IH JH 	b ae g I dZ 
BAIL 	B EY L 	b e I l 
BAIT 	B EY T 	b e I t 
BAKER 	B EY K ER 	b e I k E R 
BAKERY 	B EY K ER IY 	b e I k E R i 
BAKING 	B EY K IH NG 	b e I k I N 
BALANCE 	B AE L AH N S 	b ae l 2 n s 
BALCONY 	B AE L K AH N IY 	b ae l k 2 n i 
BALDNESS 	B AO L D N AH S 	b O l d n 2 s 
BALL 	B AO L 	b O l 
BALLERINA 	B AE L ER IY N AH 	b ae l E R i n 2 
BALLET 	B AE L EY 	b ae l e I 
BALLOT 	B AE L AH T 	b ae l 2 t 
BALLOTING 	B AE L AH T IH NG 	b ae l 2 t I N 
BALLROOM 	B AO L R UW M 	b O l r u m 
BALSA 	B AO L S AH 	b O l s 2 
BAN 	B AE N 	b ae n 
BANANA 	B AH N AE N AH 	b 2 n ae n 2 
BAND 	B AE N D 	b ae n d 
BANDWIDTH 	B AE N D W IH D TH 	b ae n d w I d T 
BANG 	B AE NG 	b ae N 
BANK 	B AE NG K 	b ae N k 
BANKING 	B AE NG K IH NG 	b ae N k I N 
BANKRUPTCY 	B AE NG K R AH P S IY 	b ae N k r 2 p s i 
BANNER 	B AE N ER 	b ae n E R 
BAR 	B AA R 	b a r 
BARBECUE 	B AA R B IH K Y UW 	b a r b I k j u 
BARBER 	B AA R B ER 	b a r b E R 
BARBERSHOP 	B AA R B ER SH AA P 	b a r b E R S a p 
BARGE 	B AA R JH 	b a r dZ 
BARN 	B AA R N 	b a r n 
BAROMETER 	B ER AA M IH T ER 	b E R a m I t E R 
BARREL 	B AE R AH L 	b ae r 2 l 
BARRIER 	B AE R IY ER 	b ae r i E R 
BARTENDER 	B AA R T EH N D ER 	b a r t E n d E R 
BASE 	B EY S 	b e I s 
BASEBALL 	B EY S B AO L 	b e I s b O l 
BASHING 	B AE SH IH NG 	b ae S I N 
BASIS 	B EY S AH S 	b e I s 2 s 
BASKET 	B AE S K AH T 	b ae s k 2 t 
BASKING 	B AE S K IH NG 	b ae s k I N 
BASS 	B AE S 	b ae s 
BAT 	B AE T 	b ae t 
BATCH 	B AE CH 	b ae tS 
BATH 	B AE TH 	b ae T 
BATHING 	B EY DH IH NG 	b e I D I N 
BATHROOM 	B AE TH R UW M 	b ae T r u m 
BATTER 	B AE T ER 	b ae t E R 
BATTERY 	B AE T ER IY 	b ae t E R i 
BATTLE 	B AE T AH L 	b ae t 2 l 
BATTLEFIELD 	B AE T AH L F IY L D 	b ae t 2 l f i l d 
BAY 	B EY 	b e I 
BEACH 	B IY CH 	b i tS 
BEAK 	B IY K 	b i k 
BEAM 	B IY M 	b i m 
BEAN 	B IY N 	b i n 
BEAR 	B EH R 	b E r 
BEARD 	B IH R D 	b I r d 
BEAT 	B IY T 	b i t 
BEATING 	B IY T IH NG 	b i t I N 
BEAUTY 	B Y UW T IY 	b j u t i 
BEAVER 	B IY V ER 	b i v E R 
BED 	B EH D 	b E d 
BEDDING 	B EH D IH NG 	b E d I N 
BEDLAM 	B EH D L AH M 	b E d l 2 m 
BEDROOM 	B EH D R UW M 	b E d r u m 
BEE 	B IY 	b i 
BEEF 	B IY F 	b i f 
BEER 	B IH R 	b I r 
BEGINNER 	B IH G IH N ER 	b I g I n E R 
BEGINNING 	B IH G IH N IH NG 	b I g I n I N 
BEHALF 	B IH HH AE F 	b I h ae f 
BEHAVIOR 	B IH HH EY V Y ER 	b I h e I v j E R 
BEING 	B IY IH NG 	b i I N 
BELIEF 	B IH L IY F 	b I l i f 
BELIEVER 	B IH L IY V ER 	b I l i v E R 
BELL 	B EH L 	b E l 
BELLY 	B EH L IY 	b E l i 
BELT 	B EH L T 	b E l t 
BENCH 	B EH N CH 	b E n tS 
BENEFICIARY 	B EH N AH F IH SH IY EH R IY 	b E n 2 f I S i E r i 
BENEFIT 	B EH N AH F IH T 	b E n 2 f I t 
BERRY 	B EH R IY 	b E r i 
BET 	B EH T 	b E t 
BETA 	B EY T AH 	b e I t 2 
BEVERAGE 	B EH V ER IH JH 	b E v E R I dZ 
BICYCLE 	B AY S IH K AH L 	b E I s I k 2 l 
BID 	B IH D 	b I d 
BIDDER 	B IH D ER 	b I d E R 
BIKE 	B AY K 	b E I k 
BILL 	B IH L 	b I l 
BILLIARD 	B IH L Y ER D   	b I l j E R d  
BILLING 	B IH L IH NG 	b I l I N 
BILLION 	B IH L Y AH N 	b I l j 2 n 
BINARY 	B AY N AH R IY 	b E I n 2 r i 
BIND 	B AY N D 	b E I n d 
BIOCHEMIST 	B AY OW K EH M IH S T 	b E I o U k E m I s t 
BIOLOGIST 	B AY AA L AH JH IH S T 	b E I a l 2 dZ I s t 
BIOLOGY 	B AY AA L AH JH IY 	b E I a l 2 dZ i 
BIOSPHERE 	B AY OW S F IH R 	b E I o U s f I r 
BIRD 	B ER D 	b E R d 
BIRDIE 	B ER D IY 	b E R d i 
BIRTH 	B ER TH 	b E R T 
BIRTHDAY 	B ER TH D EY 	b E R T d e I 
BIT 	B IH T 	b I t 
BITE 	B AY T 	b E I t 
BITING 	B AY T IH NG 	b E I t I N 
BITMAP 	B IH T M AE P 	b I t m ae p 
BLACK 	B L AE K 	b l ae k 
BLACKMAIL 	B L AE K M EY L 	b l ae k m e I l 
BLACKOUT 	B L AE K AW T 	b l ae k E U t 
BLADDER 	B L AE D ER 	b l ae d E R 
BLADE 	B L EY D 	b l e I d 
BLAME 	B L EY M 	b l e I m 
BLANKET 	B L AE NG K AH T 	b l ae N k 2 t 
BLAST 	B L AE S T 	b l ae s t 
BLEND 	B L EH N D 	b l E n d 
BLENDER 	B L EH N D ER 	b l E n d E R 
BLESSING 	B L EH S IH NG 	b l E s I N 
BLINDFOLD 	B L AY N D F OW L D 	b l E I n d f o U l d 
BLINDNESS 	B L AY N D N AH S 	b l E I n d n 2 s 
BLOCK 	B L AA K 	b l a k 
BLOG 	B L AO G 	b l O g 
BLOOD 	B L AH D 	b l 2 d 
BLOSSOMING 	B L AA S AH M IH NG 	b l a s 2 m I N 
BLOW 	B L OW 	b l o U 
BLOWER 	B L OW ER 	b l o U E R 
BLOWING 	B L OW IH NG 	b l o U I N 
BLOWOUT 	B L OW AW T 	b l o U E U t 
BLUE 	B L UW 	b l u 
BLUFF 	B L AH F 	b l 2 f 
BLUNDER 	B L AH N D ER 	b l 2 n d E R 
BOARD 	B AO R D 	b O r d 
BOARDER 	B AO R D ER 	b O r d E R 
BOARDING 	B AO R D IH NG 	b O r d I N 
BOARDROOM 	B AO R D R UW M 	b O r d r u m 
BOAST 	B OW S T 	b o U s t 
BOAT 	B OW T 	b o U t 
BODICE 	B AA D IH S 	b a d I s 
BODY 	B AA D IY 	b a d i 
BODYGUARD 	B AA D IY G AA R D 	b a d i g a r d 
BOIL 	B OY L 	b U I l 
BOMB 	B AA M 	b a m 
BOMBAST 	B AA M B AE S T 	b a m b ae s t 
BOMBER 	B AA M ER 	b a m E R 
BOMBING 	B AA M IH NG 	b a m I N 
BOND 	B AA N D 	b a n d 
BONE 	B OW N 	b o U n 
BONUS 	B OW N AH S 	b o U n 2 s 
BOOB 	B UW B 	b u b 
BOOK 	B UH K 	b U k 
BOOKING 	B UH K IH NG 	b U k I N 
BOOST 	B UW S T 	b u s t 
BOOSTER 	B UW S T ER 	b u s t E R 
BOOT 	B UW T 	b u t 
BOOTH 	B UW TH 	b u T 
BORDER 	B AO R D ER 	b O r d E R 
BORE 	B AO R 	b O r 
BOSS 	B AA S 	b a s 
BOTTLE 	B AA T AH L 	b a t 2 l 
BOTTOM 	B AA T AH M 	b a t 2 m 
BOULEVARD 	B UH L AH V AA R D 	b U l 2 v a r d 
BOUNCE 	B AW N S 	b E U n s 
BOUND 	B AW N D 	b E U n d 
BOUT 	B AW T 	b E U t 
BOUTIQUE 	B UW T IY K 	b u t i k 
BOWEL 	B AW AH L 	b E U 2 l 
BOWL 	B OW L 	b o U l 
BOX 	B AA K S 	b a k s 
BOXER 	B AA K S ER 	b a k s E R 
BOY 	B OY 	b U I 
BOYCOTT 	B OY K AA T 	b U I k a t 
BOYFRIEND 	B OY F R EH N D 	b U I f r E n d 
BOZO 	B OW Z OW 	b o U z o U 
BRAIN 	B R EY N 	b r e I n 
BRAINWASHING 	B R EY N W AA SH IH NG 	b r e I n w a S I N 
BRAKE 	B R EY K 	b r e I k 
BRANCH 	B R AE N CH 	b r ae n tS 
BRAND 	B R AE N D 	b r ae n d 
BRAS 	B R AE S 	b r ae s 
BRASS 	B R AE S 	b r ae s 
BRAT 	B R AE T 	b r ae t 
BRAVERY 	B R EY V ER IY 	b r e I v E R i 
BREAD 	B R EH D 	b r E d 
BREAK 	B R EY K 	b r e I k 
BREAKDOWN 	B R EY K D AW N 	b r e I k d E U n 
BREAKFAST 	B R EH K F AH S T 	b r E k f 2 s t 
BREAKING 	B R EY K IH NG 	b r e I k I N 
BREAKTHROUGH 	B R EY K TH R UW 	b r e I k T r u 
BREAST 	B R EH S T 	b r E s t 
BREATH 	B R EH TH 	b r E T 
BREATHING 	B R IY DH IH NG 	b r i D I N 
BREED 	B R IY D 	b r i d 
BREEDER 	B R IY D ER 	b r i d E R 
BREEDING 	B R IY D IH NG 	b r i d I N 
BREEZE 	B R IY Z 	b r i z 
BREWERY 	B R UW ER IY 	b r u E R i 
BRICK 	B R IH K 	b r I k 
BRIDE 	B R AY D 	b r E I d 
BRIDGE 	B R IH JH 	b r I dZ 
BRIEF 	B R IY F 	b r i f 
BRIEFING 	B R IY F IH NG 	b r i f I N 
BRIGADE 	B R AH G EY D 	b r 2 g e I d 
BRIGHTNESS 	B R AY T N AH S 	b r E I t n 2 s 
BRINK 	B R IH NG K 	b r I N k 
BRINKMANSHIP 	B R IH NG K M AH N SH IH P 	b r I N k m 2 n S I p 
BROCCOLI 	B R AA K AH L IY 	b r a k 2 l i 
BROCHURE 	B R OW SH UH R 	b r o U S U r 
BROKER 	B R OW K ER 	b r o U k E R 
BROKERAGE 	B R OW K ER IH JH 	b r o U k E R I dZ 
BRONZE 	B R AA N Z 	b r a n z 
BROTHEL 	B R AA TH AH L 	b r a T 2 l 
BROTHER 	B R AH DH ER 	b r 2 D E R 
BROWN 	B R AW N 	b r E U n 
BROWSER 	B R AW Z ER 	b r E U z E R 
BRUISE 	B R UW Z 	b r u z 
BRUNCH 	B R AH N CH 	b r 2 n tS 
BRUNT 	B R AH N T 	b r 2 n t 
BUBBLE 	B AH B AH L 	b 2 b 2 l 
BUCK 	B AH K 	b 2 k 
BUCKET 	B AH K IH T 	b 2 k I t 
BUDDY 	B AH D IY 	b 2 d i 
BUDGET 	B AH JH IH T 	b 2 dZ I t 
BUDGIE 	B AH JH IY 	b 2 dZ i 
BUG 	B AH G 	b 2 g 
BUILD 	B IH L D 	b I l d 
BUILDER 	B IH L D ER 	b I l d E R 
BUILDING 	B IH L D IH NG 	b I l d I N 
BUILDUP 	B IH L D AH P 	b I l d 2 p 
BULB 	B AH L B 	b 2 l b 
BULL 	B UH L 	b U l 
BULLET 	B UH L AH T 	b U l 2 t 
BULLETIN 	B UH L IH T AH N 	b U l I t 2 n 
BULLFIGHT 	B UH L F AY T 	b U l f E I t 
BULLSHIT 	B UH L SH IH T 	b U l S I t 
BUN 	B AH N 	b 2 n 
BUNCH 	B AH N CH 	b 2 n tS 
BUNDLE 	B AH N D AH L 	b 2 n d 2 l 
BUNGLING 	B AH NG G AH L IH NG 	b 2 N g 2 l I N 
BURDEN 	B ER D AH N 	b E R d 2 n 
BUREAU 	B Y UH R OW 	b j U r o U 
BURGER 	B ER G ER 	b E R g E R 
BURGLAR 	B ER G L ER 	b E R g l E R 
BURIAL 	B EH R IY AH L 	b E r i 2 l 
BURN 	B ER N 	b E R n 
BURNER 	B ER N ER 	b E R n E R 
BURST 	B ER S T 	b E R s t 
BUS 	B AH S 	b 2 s 
BUSH 	B UH SH 	b U S 
BUSINESS 	B IH Z N AH S 	b I z n 2 s 
BUSTER 	B AH S T ER 	b 2 s t E R 
BUSTLE 	B AH S AH L 	b 2 s 2 l 
BUSYBODY 	B IH Z IY B AA D IY 	b I z i b a d i 
BUT 	B AH T 	b 2 t 
BUTT 	B AH T 	b 2 t 
BUTTER 	B AH T ER 	b 2 t E R 
BUTTERFLY 	B AH T ER F L AY 	b 2 t E R f l E I 
BUTTON 	B AH T AH N 	b 2 t 2 n 
BUY 	B AY 	b E I 
BUYER 	B AY ER 	b E I E R 
BUYING 	B AY IH NG 	b E I I N 
BUZZING 	B AH Z IH NG 	b 2 z I N 
CAB 	K AE B 	k ae b 
CABBAGE 	K AE B AH JH 	k ae b 2 dZ 
CABIN 	K AE B AH N 	k ae b 2 n 
CABINET 	K AE B AH N AH T 	k ae b 2 n 2 t 
CACHE 	K AE SH 	k ae S 
CACTUS 	K AE K T AH S 	k ae k t 2 s 
CAFETERIA 	K AE F AH T IH R IY AH 	k ae f 2 t I r i 2 
CAGE 	K EY JH 	k e I dZ 
CAKE 	K EY K 	k e I k 
CALCIUM 	K AE L S IY AH M 	k ae l s i 2 m 
CALCULATION 	K AE L K Y AH L EY SH AH N 	k ae l k j 2 l e I S 2 n 
CALENDAR 	K AE L AH N D ER 	k ae l 2 n d E R 
CALF 	K AE F 	k ae f 
CALICO 	K AE L AH K OW 	k ae l 2 k o U 
CALL 	K AO L 	k O l 
CALLING 	K AO L IH NG 	k O l I N 
CALMNESS 	K AA M N AH S 	k a m n 2 s 
CAMEL 	K AE M AH L 	k ae m 2 l 
CAMERA 	K AE M ER AH 	k ae m E R 2 
CAMP 	K AE M P 	k ae m p 
CAMPAIGN 	K AE M P EY N 	k ae m p e I n 
CAMPAIGNING 	K AE M P EY N IH NG 	k ae m p e I n I N 
CAMPER 	K AE M P ER 	k ae m p E R 
CAMPSITE 	K AE M P S AY T 	k ae m p s E I t 
CAMPUS 	K AE M P AH S 	k ae m p 2 s 
CAN 	K AE N 	k ae n 
CANAL 	K AH N AE L 	k 2 n ae l 
CANCELLATION 	K AE N S AH L EY SH AH N 	k ae n s 2 l e I S 2 n 
CANCER 	K AE N S ER 	k ae n s E R 
CANDIDATE 	K AE N D AH D EY T 	k ae n d 2 d e I t 
CANDLE 	K AE N D AH L 	k ae n d 2 l 
CANDY 	K AE N D IY 	k ae n d i 
CANISTER 	K AE N AH S T ER 	k ae n 2 s t E R 
CANNIBAL 	K AE N AH B AH L 	k ae n 2 b 2 l 
CANNON 	K AE N AH N 	k ae n 2 n 
CANOE 	K AH N UW 	k 2 n u 
CAP 	K AE P 	k ae p 
CAPABILITY 	K EY P AH B IH L AH T IY 	k e I p 2 b I l 2 t i 
CAPACITY 	K AH P AE S AH T IY 	k 2 p ae s 2 t i 
CAPE 	K EY P 	k e I p 
CAPER 	K EY P ER 	k e I p E R 
CAPITAL 	K AE P IH T AH L 	k ae p I t 2 l 
CAPSULE 	K AE P S AH L 	k ae p s 2 l 
CAPTAIN 	K AE P T AH N 	k ae p t 2 n 
CAPTURE 	K AE P CH ER 	k ae p tS E R 
CAR 	K AA R 	k a r 
CARBON 	K AA R B AH N 	k a r b 2 n 
CARCINOMA 	K AA R S AH N OW M AH 	k a r s 2 n o U m 2 
CARD 	K AA R D 	k a r d 
CARE 	K EH R 	k E r 
CAREER 	K ER IH R 	k E R I r 
CARGO 	K AA R G OW 	k a r g o U 
CARING 	K EH R IH NG 	k E r I N 
CAROTID 	K ER AA T IH D 	k E R a t I d 
CARPENTER 	K AA R P AH N T ER 	k a r p 2 n t E R 
CARPET 	K AA R P AH T 	k a r p 2 t 
CARRIER 	K AE R IY ER 	k ae r i E R 
CARROT 	K AE R AH T 	k ae r 2 t 
CARTON 	K AA R T AH N 	k a r t 2 n 
CARTOON 	K AA R T UW N 	k a r t u n 
CASCADE 	K AE S K EY D 	k ae s k e I d 
CASE 	K EY S 	k e I s 
CASH 	K AE SH 	k ae S 
CASHIER 	K AE SH IH R 	k ae S I r 
CASINO 	K AH S IY N OW 	k 2 s i n o U 
CAST 	K AE S T 	k ae s t 
CASTING 	K AE S T IH NG 	k ae s t I N 
CASTLING 	K AE S T L IH NG 	k ae s t l I N 
CASUALTY 	K AE ZH AH W AH L T IY 	k ae Z 2 w 2 l t i 
CAT 	K AE T 	k ae t 
CATALOGUE 	K AE T AH L AO G 	k ae t 2 l O g 
CATASTROPHE 	K AH T AE S T R AH F IY 	k 2 t ae s t r 2 f i 
CATCH 	K AE CH 	k ae tS 
CATEGORY 	K AE T AH G AO R IY 	k ae t 2 g O r i 
CATER 	K EY T ER 	k e I t E R 
CATERING 	K EY T ER IH NG 	k e I t E R I N 
CATFISH 	K AE T F IH SH 	k ae t f I S 
CATTLE 	K AE T AH L 	k ae t 2 l 
CAULDRON 	K AA L D R AH N 	k a l d r 2 n 
CAULIFLOWER 	K AA L AH F L AW ER 	k a l 2 f l E U E R 
CAUSE 	K AA Z 	k a z 
CAVE 	K EY V 	k e I v 
CEASEFIRE 	S IY S F AY ER 	s i s f E I E R 
CEILING 	S IY L IH NG 	s i l I N 
CELEBRATION 	S EH L AH B R EY SH AH N 	s E l 2 b r e I S 2 n 
CELEBRITY 	S AH L EH B R IH T IY 	s 2 l E b r I t i 
CELERY 	S EH L ER IY 	s E l E R i 
CELL 	S EH L 	s E l 
CEMENT 	S AH M EH N T 	s 2 m E n t 
CENT 	S EH N T 	s E n t 
CENTER 	S EH N T ER 	s E n t E R 
CENTURY 	S EH N CH ER IY 	s E n tS E R i 
CEREAL 	S IH R IY AH L 	s I r i 2 l 
CERTAINTY 	S ER T AH N T IY 	s E R t 2 n t i 
CERTIFICATE 	S ER T IH F IH K AH T 	s E R t I f I k 2 t 
CERTIFICATION 	S ER T AH F AH K EY SH AH N 	s E R t 2 f 2 k e I S 2 n 
CHAIN 	CH EY N 	tS e I n 
CHAIR 	CH EH R 	tS E r 
CHAIRPERSON 	CH EH R P ER S AH N 	tS E r p E R s 2 n 
CHALLENGE 	CH AE L AH N JH 	tS ae l 2 n dZ 
CHAMBER 	CH EY M B ER 	tS e I m b E R 
CHAMBERMAID 	CH EY M B ER M EY D 	tS e I m b E R m e I d 
CHANCE 	CH AE N S 	tS ae n s 
CHANDELIER 	SH AE N D AH L IH R 	S ae n d 2 l I r 
CHANGE 	CH EY N JH 	tS e I n dZ 
CHANGING 	CH EY N JH IH NG 	tS e I n dZ I N 
CHANNEL 	CH AE N AH L 	tS ae n 2 l 
CHANT 	CH AE N T 	tS ae n t 
CHAOS 	K EY AA S 	k e I a s 
CHAP 	CH AE P 	tS ae p 
CHAPEL 	CH AE P AH L 	tS ae p 2 l 
CHAPTER 	CH AE P T ER 	tS ae p t E R 
CHARACTER 	K EH R IH K T ER 	k E r I k t E R 
CHARCOAL 	CH AA R K OW L 	tS a r k o U l 
CHARGE 	CH AA R JH 	tS a r dZ 
CHARITY 	CH EH R IH T IY 	tS E r I t i 
CHARM 	CH AA R M 	tS a r m 
CHART 	CH AA R T 	tS a r t 
CHASE 	CH EY S 	tS e I s 
CHASM 	K AE Z AH M 	k ae z 2 m 
CHAT 	CH AE T 	tS ae t 
CHAUVINISM 	SH OW V AH N IH Z AH M 	S o U v 2 n I z 2 m 
CHECK 	CH EH K 	tS E k 
CHECKOUT 	CH EH K AW T 	tS E k E U t 
CHEEK 	CH IY K 	tS i k 
CHEER 	CH IH R 	tS I r 
CHEESE 	CH IY Z 	tS i z 
CHEF 	SH EH F 	S E f 
CHEMICAL 	K EH M IH K AH L 	k E m I k 2 l 
CHEMISTRY 	K EH M IH S T R IY 	k E m I s t r i 
CHESS 	CH EH S 	tS E s 
CHEST 	CH EH S T 	tS E s t 
CHEW 	CH UW 	tS u 
CHICK 	CH IH K 	tS I k 
CHICKEN 	CH IH K AH N 	tS I k 2 n 
CHIEF 	CH IY F 	tS i f 
CHILDBIRTH 	CH AY L D B ER TH 	tS E I l d b E R T 
CHILDCARE 	CH AY L D K EH R 	tS E I l d k E r 
CHILDHOOD 	CH AY L D HH UH D 	tS E I l d h U d 
CHILI 	CH IH L IY 	tS I l i 
CHIP 	CH IH P 	tS I p 
CHLORIDE 	K L AO R AY D 	k l O r E I d 
CHLORINATION 	K L OW R IY N EY SH AH N 	k l o U r i n e I S 2 n 
CHLORINE 	K L AO R IY N 	k l O r i n 
CHOCOLATE 	CH AO K L AH T 	tS O k l 2 t 
CHOICE 	CH OY S 	tS U I s 
CHOIR 	K W AY ER 	k w E I E R 
CHORD 	K AO R D 	k O r d 
CHORE 	CH AO R 	tS O r 
CHROME 	K R OW M 	k r o U m 
CHUNK 	CH AH NG K 	tS 2 N k 
CHURCH 	CH ER CH 	tS E R tS 
CIGARETTE 	S IH G AH R EH T 	s I g 2 r E t 
CINEMA 	S IH N AH M AH 	s I n 2 m 2 
CIRCLE 	S ER K AH L 	s E R k 2 l 
CIRCUMSTANCE 	S ER K AH M S T AE N S 	s E R k 2 m s t ae n s 
CITIZEN 	S IH T AH Z AH N 	s I t 2 z 2 n 
CITIZENSHIP 	S IH T IH Z AH N SH IH P 	s I t I z 2 n S I p 
CITY 	S IH T IY 	s I t i 
CIVET 	S IH V AH T 	s I v 2 t 
CIVILIAN 	S AH V IH L Y AH N 	s 2 v I l j 2 n 
CIVILIZATION 	S IH V AH L IH Z EY SH AH N 	s I v 2 l I z e I S 2 n 
CLAIM 	K L EY M 	k l e I m 
CLAMORING 	K L AE M ER IH NG 	k l ae m E R I N 
CLAMP 	K L AE M P 	k l ae m p 
CLAN 	K L AE N 	k l ae n 
CLARIFICATION 	K L EH R AH F AH K EY SH AH N 	k l E r 2 f 2 k e I S 2 n 
CLASH 	K L AE SH 	k l ae S 
CLASS 	K L AE S 	k l ae s 
CLASSIC 	K L AE S IH K 	k l ae s I k 
CLASSMATE 	K L AE S M EY T 	k l ae s m e I t 
CLAUSE 	K L AO Z 	k l O z 
CLAW 	K L AO 	k l O 
CLAY 	K L EY 	k l e I 
CLEAN 	K L IY N 	k l i n 
CLEANER 	K L IY N ER 	k l i n E R 
CLEANING 	K L IY N IH NG 	k l i n I N 
CLERGY 	K L ER JH IY 	k l E R dZ i 
CLERIC 	K L EH R IH K 	k l E r I k 
CLERK 	K L ER K 	k l E R k 
CLIENT 	K L AY AH N T 	k l E I 2 n t 
CLIMATE 	K L AY M AH T 	k l E I m 2 t 
CLIMBER 	K L AY M ER 	k l E I m E R 
CLINIC 	K L IH N IH K 	k l I n I k 
CLIP 	K L IH P 	k l I p 
CLOAK 	K L OW K 	k l o U k 
CLOCK 	K L AA K 	k l a k 
CLOCKWORK 	K L AA K W ER K 	k l a k w E R k 
CLOSE 	K L OW S 	k l o U s 
CLOSING 	K L OW Z IH NG 	k l o U z I N 
CLOTH 	K L AO TH 	k l O T 
CLOTHING 	K L OW DH IH NG 	k l o U D I N 
CLOUD 	K L AW D 	k l E U d 
CLUB 	K L AH B 	k l 2 b 
CLUBHOUSE 	K L AH B HH AW S 	k l 2 b h E U s 
CLUE 	K L UW 	k l u 
CLUMP 	K L AH M P 	k l 2 m p 
CLUSTER 	K L AH S T ER 	k l 2 s t E R 
COACH 	K OW CH 	k o U tS 
COAL 	K OW L 	k o U l 
COALITION 	K OW AH L IH SH AH N 	k o U 2 l I S 2 n 
COAST 	K OW S T 	k o U s t 
COASTAL 	K OW S T AH L 	k o U s t 2 l 
COASTLINE 	K OW S T L AY N 	k o U s t l E I n 
COAT 	K OW T 	k o U t 
COATING 	K OW T IH NG 	k o U t I N 
COB 	K AA B 	k a b 
COCKTAIL 	K AA K T EY L 	k a k t e I l 
COCONUT 	K OW K AH N AH T 	k o U k 2 n 2 t 
CODE 	K OW D 	k o U d 
CODING 	K OW D IH NG 	k o U d I N 
COFFEE 	K AA F IY 	k a f i 
COFFIN 	K AO F IH N 	k O f I n 
COIN 	K OY N 	k U I n 
COINCIDENCE 	K OW IH N S IH D AH N S 	k o U I n s I d 2 n s 
COLLABORATION 	K AH L AE B ER EY SH AH N 	k 2 l ae b E R e I S 2 n 
COLLAGE 	K AH L AA ZH 	k 2 l a Z 
COLLAPSE 	K AH L AE P S 	k 2 l ae p s 
COLLAR 	K AA L ER 	k a l E R 
COLLATERAL 	K AH L AE T ER AH L 	k 2 l ae t E R 2 l 
COLLEAGUE 	K AA L IY G 	k a l i g 
COLLECTION 	K AH L EH K SH AH N 	k 2 l E k S 2 n 
COLLEGE 	K AA L IH JH 	k a l I dZ 
COLLISION 	K AH L IH ZH AH N 	k 2 l I Z 2 n 
COLLUSION 	K AH L UW ZH AH N 	k 2 l u Z 2 n 
COLONIZATION 	K AA L AH N IH Z EY SH AH N 	k a l 2 n I z e I S 2 n 
COLONY 	K AA L AH N IY 	k a l 2 n i 
COLOR 	K AH L ER 	k 2 l E R 
COLUMN 	K AA L AH M 	k a l 2 m 
COLUMNIST 	K AA L AH M N AH S T 	k a l 2 m n 2 s t 
COMB 	K OW M 	k o U m 
COMBAT 	K AA M B AE T 	k a m b ae t 
COMBATANT 	K AH M B AE T AH N T 	k 2 m b ae t 2 n t 
COMBINATION 	K AA M B AH N EY SH AH N 	k a m b 2 n e I S 2 n 
COMBO 	K AA M B OW 	k a m b o U 
COMEDIAN 	K AH M IY D IY AH N 	k 2 m i d i 2 n 
COMEDY 	K AA M AH D IY 	k a m 2 d i 
COMER 	K AH M ER 	k 2 m E R 
COMFORT 	K AH M F ER T 	k 2 m f E R t 
COMMA 	K AA M AH 	k a m 2 
COMMAND 	K AH M AE N D 	k 2 m ae n d 
COMMANDER 	K AH M AE N D ER 	k 2 m ae n d E R 
COMMENT 	K AA M EH N T 	k a m E n t 
COMMENTARY 	K AA M AH N T EH R IY 	k a m 2 n t E r i 
COMMENTATOR 	K AA M AH N T EY T ER 	k a m 2 n t e I t E R 
COMMERCIAL 	K AH M ER SH AH L 	k 2 m E R S 2 l 
COMMISSION 	K AH M IH SH AH N 	k 2 m I S 2 n 
COMMISSIONER 	K AH M IH SH AH N ER 	k 2 m I S 2 n E R 
COMMITMENT 	K AH M IH T M AH N T 	k 2 m I t m 2 n t 
COMMITTEE 	K AH M IH T IY 	k 2 m I t i 
COMMODITY 	K AH M AA D AH T IY 	k 2 m a d 2 t i 
COMMUNICATION 	K AH M Y UW N AH K EY SH AH N 	k 2 m j u n 2 k e I S 2 n 
COMMUNICATOR 	K AH M Y UW N AH K EY T ER 	k 2 m j u n 2 k e I t E R 
COMMUNITY 	K AH M Y UW N AH T IY 	k 2 m j u n 2 t i 
COMPANION 	K AH M P AE N Y AH N 	k 2 m p ae n j 2 n 
COMPANY 	K AH M P AH N IY 	k 2 m p 2 n i 
COMPARISON 	K AH M P EH R AH S AH N 	k 2 m p E r 2 s 2 n 
COMPASSION 	K AH M P AE SH AH N 	k 2 m p ae S 2 n 
COMPENSATION 	K AA M P AH N S EY SH AH N 	k a m p 2 n s e I S 2 n 
COMPETITION 	K AA M P AH T IH SH AH N 	k a m p 2 t I S 2 n 
COMPLAINT 	K AH M P L EY N T 	k 2 m p l e I n t 
COMPLETION 	K AH M P L IY SH AH N 	k 2 m p l i S 2 n 
COMPLEX 	K AA M P L EH K S 	k a m p l E k s 
COMPLEXITY 	K AH M P L EH K S AH T IY 	k 2 m p l E k s 2 t i 
COMPLIANCE 	K AH M P L AY AH N S 	k 2 m p l E I 2 n s 
COMPLICATION 	K AA M P L AH K EY SH AH N 	k a m p l 2 k e I S 2 n 
COMPLIMENT 	K AA M P L AH M EH N T 	k a m p l 2 m E n t 
COMPONENT 	K AH M P OW N AH N T 	k 2 m p o U n 2 n t 
COMPOSITION 	K AA M P AH Z IH SH AH N 	k a m p 2 z I S 2 n 
COMPOUND 	K AA M P AW N D 	k a m p E U n d 
COMPREHENSION 	K AA M P R IY HH EH N SH AH N 	k a m p r i h E n S 2 n 
COMPRESSION 	K AH M P R EH SH AH N 	k 2 m p r E S 2 n 
COMPRESSOR 	K AH M P R EH S ER 	k 2 m p r E s E R 
COMPROMISE 	K AA M P R AH M AY Z 	k a m p r 2 m E I z 
COMPUTER 	K AH M P Y UW T ER 	k 2 m p j u t E R 
CON 	K AA N 	k a n 
CONCENTRATION 	K AA N S AH N T R EY SH AH N 	k a n s 2 n t r e I S 2 n 
CONCEPT 	K AA N S EH P T 	k a n s E p t 
CONCERN 	K AH N S ER N 	k 2 n s E R n 
CONCERT 	K AA N S ER T 	k a n s E R t 
CONCLUSION 	K AH N K L UW ZH AH N 	k 2 n k l u Z 2 n 
CONCRETE 	K AH N K R IY T 	k 2 n k r i t 
CONDEMNATION 	K AA N D AH M N EY SH AH N 	k a n d 2 m n e I S 2 n 
CONDIMENT 	K AA N D AH M AH N T 	k a n d 2 m 2 n t 
CONDITION 	K AH N D IH SH AH N 	k 2 n d I S 2 n 
CONDITIONER 	K AH N D IH SH AH N ER 	k 2 n d I S 2 n E R 
CONDITIONING 	K AH N D IH SH AH N IH NG 	k 2 n d I S 2 n I N 
CONDO 	K AA N D OW 	k a n d o U 
CONDOMINIUM 	K AA N D AH M IH N IY AH M 	k a n d 2 m I n i 2 m 
CONDUCT 	K AA N D AH K T 	k a n d 2 k t 
CONDUIT 	K AA N D UW IH T 	k a n d u I t 
CONFERENCE 	K AA N F ER AH N S 	k a n f E R 2 n s 
CONFESSION 	K AH N F EH SH AH N 	k 2 n f E S 2 n 
CONFIDANTE 	K AA N F AH D AE N T 	k a n f 2 d ae n t 
CONFIDENCE 	K AA N F AH D EH N S 	k a n f 2 d E n s 
CONFIDENTIALITY 	K AA N F AH D EH N SH IY AE L AH T IY 	k a n f 2 d E n S i ae l 2 t i 
CONFINE 	K AA N F AY N   	k a n f E I n  
CONFIRM 	K AH N F ER M 	k 2 n f E R m 
CONFIRMATION 	K AA N F ER M EY SH AH N 	k a n f E R m e I S 2 n 
CONFISCATION 	K AA N F AH S K EY SH AH N 	k a n f 2 s k e I S 2 n 
CONFLAGRATION 	K AA N F L AH G R EY SH AH N 	k a n f l 2 g r e I S 2 n 
CONFLICT 	K AA N F L IH K T 	k a n f l I k t 
CONFLUENCE 	K AA N F L UW AH N S 	k a n f l u 2 n s 
CONFORMITY 	K AH N F AO R M AH T IY 	k 2 n f O r m 2 t i 
CONFRONTATION 	K AA N F R AH N T EY SH AH N 	k a n f r 2 n t e I S 2 n 
CONFUSION 	K AH N F Y UW ZH AH N 	k 2 n f j u Z 2 n 
CONGLOMERATE 	K AH N G L AA M ER AH T 	k 2 n g l a m E R 2 t 
CONGRATULATION 	K AH N G R AE CH AH L EY SH AH N 	k 2 n g r ae tS 2 l e I S 2 n 
CONGREGATION 	K AA NG G R AH G EY SH AH N 	k a N g r 2 g e I S 2 n 
CONGRESS 	K AA NG G R AH S 	k a N g r 2 s 
CONJUNCTION 	K AH N JH AH NG K SH AH N 	k 2 n dZ 2 N k S 2 n 
CONNECTION 	K AH N EH K SH AH N 	k 2 n E k S 2 n 
CONNOISSEUR 	K AA N AH S ER 	k a n 2 s E R 
CONQUEST 	K AA NG K W EH S T 	k a N k w E s t 
CONSCIENCE 	K AA N SH AH N S 	k a n S 2 n s 
CONSCIOUSNESS 	K AA N SH AH S N AH S 	k a n S 2 s n 2 s 
CONSENSUS 	K AH N S EH N S AH S 	k 2 n s E n s 2 s 
CONSENT 	K AH N S EH N T 	k 2 n s E n t 
CONSEQUENCE 	K AA N S AH K W AH N S 	k a n s 2 k w 2 n s 
CONSERVATION 	K AA N S ER V EY SH AH N 	k a n s E R v e I S 2 n 
CONSERVATIONIST 	K AA N S ER V EY SH AH N IH S T 	k a n s E R v e I S 2 n I s t 
CONSERVATIVE 	K AH N S ER V AH T IH V 	k 2 n s E R v 2 t I v 
CONSIDERATION 	K AH N S IH D ER EY SH AH N 	k 2 n s I d E R e I S 2 n 
CONSISTENCY 	K AH N S IH S T AH N S IY 	k 2 n s I s t 2 n s i 
CONSOLE 	K AA N S OW L 	k a n s o U l 
CONSOLIDATION 	K AH N S AA L AH D EY SH AH N 	k 2 n s a l 2 d e I S 2 n 
CONSORTIUM 	K AH N S AO R SH IY AH M 	k 2 n s O r S i 2 m 
CONSPIRACY 	K AH N S P IH R AH S IY 	k 2 n s p I r 2 s i 
CONSPIRATOR 	K AH N S P IH R AH T ER 	k 2 n s p I r 2 t E R 
CONSTITUTION 	K AA N S T AH T UW SH AH N 	k a n s t 2 t u S 2 n 
CONSTRAINT 	K AH N S T R EY N T 	k 2 n s t r e I n t 
CONSTRUCTION 	K AH N S T R AH K SH AH N 	k 2 n s t r 2 k S 2 n 
CONSULATE 	K AA N S AH L AH T 	k a n s 2 l 2 t 
CONSULTANT 	K AH N S AH L T AH N T 	k 2 n s 2 l t 2 n t 
CONSULTING 	K AH N S AH L T IH NG 	k 2 n s 2 l t I N 
CONSUMER 	K AH N S UW M ER 	k 2 n s u m E R 
CONSUMPTION 	K AH N S AH M P SH AH N 	k 2 n s 2 m p S 2 n 
CONTACT 	K AA N T AE K T 	k a n t ae k t 
CONTAINER 	K AH N T EY N ER 	k 2 n t e I n E R 
CONTEMPORARY 	K AH N T EH M P ER EH R IY 	k 2 n t E m p E R E r i 
CONTENDER 	K AH N T EH N D ER 	k 2 n t E n d E R 
CONTENT 	K AA N T EH N T 	k a n t E n t 
CONTEST 	K AA N T EH S T 	k a n t E s t 
CONTEXT 	K AA N T EH K S T 	k a n t E k s t 
CONTINENT 	K AA N T AH N AH N T 	k a n t 2 n 2 n t 
CONTINGENCY 	K AH N T IH N JH AH N S IY 	k 2 n t I n dZ 2 n s i 
CONTRACT 	K AA N T R AE K T 	k a n t r ae k t 
CONTRACTING 	K AA N T R AE K T IH NG 	k a n t r ae k t I N 
CONTRACTION 	K AH N T R AE K SH AH N 	k 2 n t r ae k S 2 n 
CONTRACTOR 	K AA N T R AE K T ER 	k a n t r ae k t E R 
CONTRAST 	K AA N T R AE S T 	k a n t r ae s t 
CONTRIBUTION 	K AA N T R AH B Y UW SH AH N 	k a n t r 2 b j u S 2 n 
CONTRIBUTOR 	K AH N T R IH B Y AH T ER 	k 2 n t r I b j 2 t E R 
CONTROL 	K AH N T R OW L 	k 2 n t r o U l 
CONTROLLER 	K AH N T R OW L ER 	k 2 n t r o U l E R 
CONTROVERSY 	K AA N T R AH V ER S IY 	k a n t r 2 v E R s i 
CONUNDRUM 	K AH N AH N D R AH M 	k 2 n 2 n d r 2 m 
CONVENIENCE 	K AH N V IY N Y AH N S 	k 2 n v i n j 2 n s 
CONVENTION 	K AH N V EH N SH AH N 	k 2 n v E n S 2 n 
CONVERSATION 	K AA N V ER S EY SH AH N 	k a n v E R s e I S 2 n 
CONVERTER 	K AH N V ER T ER 	k 2 n v E R t E R 
CONVEYOR 	K AH N V EY ER 	k 2 n v e I E R 
CONVICT 	K AA N V IH K T 	k a n v I k t 
CONVICTION 	K AH N V IH K SH AH N 	k 2 n v I k S 2 n 
CONVOY 	K AA N V OY 	k a n v U I 
COOKBOOK 	K UH K B UH K 	k U k b U k 
COOKIE 	K UH K IY 	k U k i 
COOKING 	K UH K IH NG 	k U k I N 
COOP 	K UW P 	k u p 
COOPERATION 	K OW AA P ER EY SH AH N 	k o U a p E R e I S 2 n 
COORDINATION 	K OW AO R D AH N EY SH AH N 	k o U O r d 2 n e I S 2 n 
COORDINATOR 	K OW AO R D AH N EY T ER 	k o U O r d 2 n e I t E R 
COP 	K AA P 	k a p 
COPY 	K AA P IY 	k a p i 
COPYING 	K AA P IY IH NG 	k a p i I N 
COPYRIGHT 	K AA P IY R AY T 	k a p i r E I t 
CORD 	K AO R D 	k O r d 
CORE 	K AO R 	k O r 
CORK 	K AO R K 	k O r k 
CORKING 	K AO R K IH NG 	k O r k I N 
CORN 	K AO R N 	k O r n 
CORNER 	K AO R N ER 	k O r n E R 
CORPORATION 	K AO R P ER EY SH AH N 	k O r p E R e I S 2 n 
CORRECTION 	K ER EH K SH AH N 	k E R E k S 2 n 
CORRELATION 	K AO R AH L EY SH AH N 	k O r 2 l e I S 2 n 
CORRESPONDENCE 	K AO R AH S P AA N D AH N S 	k O r 2 s p a n d 2 n s 
CORRESPONDENT 	K AO R AH S P AA N D AH N T 	k O r 2 s p a n d 2 n t 
COSMOS 	K AA Z M OW S 	k a z m o U s 
COST 	K AA S T 	k a s t 
COSTUME 	K AA S T UW M 	k a s t u m 
COTTON 	K AA T AH N 	k a t 2 n 
COTTONWOOD 	K AA T AH N W UH D 	k a t 2 n w U d 
COUCH 	K AW CH 	k E U tS 
COUNCIL 	K AW N S AH L 	k E U n s 2 l 
COUNSEL 	K AW N S AH L 	k E U n s 2 l 
COUNSELING 	K AW N S AH L IH NG 	k E U n s 2 l I N 
COUNSELOR 	K AW N S AH L ER 	k E U n s 2 l E R 
COUNT 	K AW N T 	k E U n t 
COUNTER 	K AW N T ER 	k E U n t E R 
COUNTERINTELLIGENCE 	K AW N T ER IH N T EH L IH JH AH N S 	k E U n t E R I n t E l I dZ 2 n s 
COUNTERWEIGHT 	K AW N T ER W EY T 	k E U n t E R w e I t 
COUNTRY 	K AH N T R IY 	k 2 n t r i 
COUNTRYMAN 	K AH N T R IY M AH N 	k 2 n t r i m 2 n 
COUNTRYSIDE 	K AH N T R IY S AY D 	k 2 n t r i s E I d 
COUNTY 	K AW N T IY 	k E U n t i 
COUP 	K UW 	k u 
COUPLE 	K AH P AH L 	k 2 p 2 l 
COUPON 	K UW P AO N 	k u p O n 
COURAGE 	K ER IH JH 	k E R I dZ 
COURSE 	K AO R S 	k O r s 
COURT 	K AO R T 	k O r t 
COURTESY 	K ER T AH S IY 	k E R t 2 s i 
COUSIN 	K AH Z AH N 	k 2 z 2 n 
COVER 	K AH V ER 	k 2 v E R 
COVERAGE 	K AH V ER AH JH 	k 2 v E R 2 dZ 
COW 	K AW 	k E U 
COWBOY 	K AW B OY 	k E U b U I 
COWORKER 	K OW W ER K ER 	k o U w E R k E R 
CRAB 	K R AE B 	k r ae b 
CRACK 	K R AE K 	k r ae k 
CRACKDOWN 	K R AE K D AW N 	k r ae k d E U n 
CRACKER 	K R AE K ER 	k r ae k E R 
CRACKPOT 	K R AE K P AA T 	k r ae k p a t 
CRAFT 	K R AE F T 	k r ae f t 
CRAP 	K R AE P 	k r ae p 
CRASH 	K R AE SH 	k r ae S 
CRATE 	K R EY T 	k r e I t 
CRAVING 	K R EY V IH NG 	k r e I v I N 
CRAWFISH 	K R AO F IH SH 	k r O f I S 
CREATION 	K R IY EY SH AH N 	k r i e I S 2 n 
CREATIVITY 	K R IY EY T IH V AH T IY 	k r i e I t I v 2 t i 
CREATURE 	K R IY CH ER 	k r i tS E R 
CREDENCE 	K R IY D AH N S 	k r i d 2 n s 
CREDIBILITY 	K R EH D AH B IH L IH T IY 	k r E d 2 b I l I t i 
CREDIT 	K R EH D AH T 	k r E d 2 t 
CREDITOR 	K R EH D AH T ER 	k r E d 2 t E R 
CREPE 	K R EY P 	k r e I p 
CREST 	K R EH S T 	k r E s t 
CRETIN 	K R IY T AH N 	k r i t 2 n 
CREW 	K R UW 	k r u 
CRICKET 	K R IH K IH T 	k r I k I t 
CRIME 	K R AY M 	k r E I m 
CRIMINAL 	K R IH M AH N AH L 	k r I m 2 n 2 l 
CRISIS 	K R AY S AH S 	k r E I s 2 s 
CRITERIA 	K R AY T IH R IY AH 	k r E I t I r i 2 
CRITERION 	K R AY T IH R IY AH N 	k r E I t I r i 2 n 
CRITIC 	K R IH T IH K 	k r I t I k 
CRITICISM 	K R IH T IH S IH Z AH M 	k r I t I s I z 2 m 
CRITTER 	K R IH T ER 	k r I t E R 
CROISSANT 	K W AA S AA N T 	k w a s a n t 
CROOK 	K R UH K 	k r U k 
CROP 	K R AA P 	k r a p 
CROSS 	K R AO S 	k r O s 
CROSSING 	K R AO S IH NG 	k r O s I N 
CROWD 	K R AW D 	k r E U d 
CROWN 	K R AW N 	k r E U n 
CRUCIBLE 	K R UW S AH B AH L 	k r u s 2 b 2 l 
CRUDE 	K R UW D 	k r u d 
CRUELTY 	K R UW L T IY 	k r u l t i 
CRUISE 	K R UW Z 	k r u z 
CRUSADER 	K R UW S EY D ER 	k r u s e I d E R 
CRUST 	K R AH S T 	k r 2 s t 
CRUSTACEAN 	K R AH S T EY SH AH N 	k r 2 s t e I S 2 n 
CRY 	K R AY 	k r E I 
CUBE 	K Y UW B 	k j u b 
CUCKOO 	K AH K UW 	k 2 k u 
CUCUMBER 	K Y UW K AH M B ER 	k j u k 2 m b E R 
CUE 	K Y UW 	k j u 
CUISINE 	K W IH Z IY N 	k w I z i n 
CULPRIT 	K AH L P R IH T 	k 2 l p r I t 
CULT 	K AH L T 	k 2 l t 
CULTURE 	K AH L CH ER 	k 2 l tS E R 
CUP 	K AH P 	k 2 p 
CURATE 	K Y UH R AH T 	k j U r 2 t 
CURB 	K ER B 	k E R b 
CURE 	K Y UH R 	k j U r 
CURFEW 	K ER F Y UW 	k E R f j u 
CURRENCY 	K ER AH N S IY 	k E R 2 n s i 
CURRENT 	K ER AH N T 	k E R 2 n t 
CURSE 	K ER S 	k E R s 
CURSOR 	K ER S ER 	k E R s E R 
CURTAIN 	K ER T AH N 	k E R t 2 n 
CURVE 	K ER V 	k E R v 
CUSSING 	K AH S IH NG 	k 2 s I N 
CUSTODY 	K AH S T AH D IY 	k 2 s t 2 d i 
CUSTOM 	K AH S T AH M 	k 2 s t 2 m 
CUSTOMER 	K AH S T AH M ER 	k 2 s t 2 m E R 
CUT 	K AH T 	k 2 t 
CUTICLE 	K Y UW T AH K AH L 	k j u t 2 k 2 l 
CUTLERY 	K AH T L ER IY 	k 2 t l E R i 
CUTTER 	K AH T ER 	k 2 t E R 
CUTTING 	K AH T IH NG 	k 2 t I N 
CYANIDE 	S AY AH N AY D 	s E I 2 n E I d 
CYCLE 	S AY K AH L 	s E I k 2 l 
CYCLING 	S AY K AH L IH NG 	s E I k 2 l I N 
CYLINDER 	S IH L AH N D ER 	s I l 2 n d E R 
DAD 	D AE D 	d ae d 
DADDY 	D AE D IY 	d ae d i 
DAILY 	D EY L IY 	d e I l i 
DAISY 	D EY Z IY 	d e I z i 
DALE 	D EY L 	d e I l 
DAMAGE 	D AE M AH JH 	d ae m 2 dZ 
DAMN 	D AE M 	d ae m 
DANCE 	D AE N S 	d ae n s 
DANCER 	D AE N S ER 	d ae n s E R 
DANCING 	D AE N S IH NG 	d ae n s I N 
DANDELION 	D AE N D AH L AY AH N 	d ae n d 2 l E I 2 n 
DANDY 	D AE N D IY 	d ae n d i 
DANGER 	D EY N JH ER 	d e I n dZ E R 
DARK 	D AA R K 	d a r k 
DARKNESS 	D AA R K N AH S 	d a r k n 2 s 
DARKROOM 	D AA R K R UW M 	d a r k r u m 
DARN 	D AA R N 	d a r n 
DATA 	D EY T AH 	d e I t 2 
DATABASE 	D EY T AH B EY S 	d e I t 2 b e I s 
DATE 	D EY T 	d e I t 
DATING 	D EY T IH NG 	d e I t I N 
DAUGHTER 	D AO T ER 	d O t E R 
DAY 	D EY 	d e I 
DAYTIME 	D EY T AY M 	d e I t E I m 
DEACON 	D IY K AH N 	d i k 2 n 
DEADLINE 	D EH D L AY N 	d E d l E I n 
DEAL 	D IY L 	d i l 
DEALER 	D IY L ER 	d i l E R 
DEALERSHIP 	D IY L ER SH IH P 	d i l E R S I p 
DEAN 	D IY N 	d i n 
DEAR 	D IH R 	d I r 
DEATH 	D EH TH 	d E T 
DEBATE 	D AH B EY T 	d 2 b e I t 
DEBIT 	D EH B IH T 	d E b I t 
DEBRIS 	D AH B R IY 	d 2 b r i 
DEBT 	D EH T 	d E t 
DEBTOR 	D EH T ER 	d E t E R 
DECADE 	D EH K EY D 	d E k e I d 
DECIDED 	D IH S AY D IH D 	d I s E I d I d 
DECISION 	D IH S IH ZH AH N 	d I s I Z 2 n 
DECK 	D EH K 	d E k 
DECKING 	D EH K IH NG 	d E k I N 
DECLARATION 	D EH K L ER EY SH AH N 	d E k l E R e I S 2 n 
DECLINE 	D IH K L AY N 	d I k l E I n 
DECOR 	D IH K AO R 	d I k O r 
DECREASE 	D IH K R IY S 	d I k r i s 
DEDICATION 	D EH D AH K EY SH AH N 	d E d 2 k e I S 2 n 
DEED 	D IY D 	d i d 
DEFAMATION 	D EH F AH M EY SH AH N 	d E f 2 m e I S 2 n 
DEFAULT 	D IH F AO L T 	d I f O l t 
DEFEAT 	D IH F IY T 	d I f i t 
DEFECT 	D IY F EH K T 	d i f E k t 
DEFENDANT 	D IH F EH N D AH N T 	d I f E n d 2 n t 
DEFENSE 	D IH F EH N S 	d I f E n s 
DEFICIENCY 	D IH F IH SH AH N S IY 	d I f I S 2 n s i 
DEFICIT 	D EH F AH S AH T 	d E f 2 s 2 t 
DEFINITION 	D EH F AH N IH SH AH N 	d E f 2 n I S 2 n 
DEGENERATE 	D IH JH EH N ER AH T 	d I dZ E n E R 2 t 
DEGREE 	D IH G R IY 	d I g r i 
DELAY 	D IH L EY 	d I l e I 
DELEGATE 	D EH L AH G EY T 	d E l 2 g e I t 
DELEGATION 	D EH L AH G EY SH AH N 	d E l 2 g e I S 2 n 
DELI 	D EH L IY 	d E l i 
DELICACY 	D EH L AH K AH S IY 	d E l 2 k 2 s i 
DELICIOUSNESS 	D IH L IH SH AH S N AH S 	d I l I S 2 s n 2 s 
DELIGHT 	D IH L AY T 	d I l E I t 
DELIVERY 	D IH L IH V ER IY 	d I l I v E R i 
DELTA 	D EH L T AH 	d E l t 2 
DEMAND 	D IH M AE N D 	d I m ae n d 
DEMISE 	D IH M AY Z 	d I m E I z 
DEMOCRACY 	D IH M AA K R AH S IY 	d I m a k r 2 s i 
DEMOCRAT 	D EH M AH K R AE T 	d E m 2 k r ae t 
DEMON 	D IY M AH N 	d i m 2 n 
DEMONSTRATION 	D EH M AH N S T R EY SH AH N 	d E m 2 n s t r e I S 2 n 
DEMOTION 	D IH M OW SH AH N 	d I m o U S 2 n 
DENIAL 	D IH N AY AH L 	d I n E I 2 l 
DENTIST 	D EH N T AH S T 	d E n t 2 s t 
DENUNCIATION 	D IH N AH N S IY EY SH AH N 	d I n 2 n s i e I S 2 n 
DEPARTMENT 	D IH P AA R T M AH N T 	d I p a r t m 2 n t 
DEPARTURE 	D IH P AA R CH ER 	d I p a r tS E R 
DEPENDENCY 	D IH P EH N D AH N S IY 	d I p E n d 2 n s i 
DEPICTION 	D IH P IH K SH AH N 	d I p I k S 2 n 
DEPLOYMENT 	D IH P L OY M AH N T 	d I p l U I m 2 n t 
DEPOSIT 	D AH P AA Z IH T 	d 2 p a z I t 
DEPOSITION 	D EH P AH Z IH SH AH N 	d E p 2 z I S 2 n 
DEPOT 	D IY P OW 	d i p o U 
DEPTH 	D EH P TH 	d E p T 
DEPUTY 	D EH P Y AH T IY 	d E p j 2 t i 
DERAILING 	D IH R EY L IH NG 	d I r e I l I N 
DEREGULATION 	D IY R EH G Y AH L EY SH AH N 	d i r E g j 2 l e I S 2 n 
DERIVATIVE 	D ER IH V AH T IH V 	d E R I v 2 t I v 
DESCENDANT 	D IH S EH N D AH N T 	d I s E n d 2 n t 
DESCRIPTION 	D IH S K R IH P SH AH N 	d I s k r I p S 2 n 
DESIGN 	D IH Z AY N 	d I z E I n 
DESIGNER 	D IH Z AY N ER 	d I z E I n E R 
DESIRE 	D IH Z AY ER 	d I z E I E R 
DESK 	D EH S K 	d E s k 
DESPAIR 	D IH S P EH R 	d I s p E r 
DESPERATION 	D EH S P ER EY SH AH N 	d E s p E R e I S 2 n 
DESPOTISM 	D EH S P AH T IH Z AH M 	d E s p 2 t I z 2 m 
DESSERT 	D IH Z ER T 	d I z E R t 
DESTINATION 	D EH S T AH N EY SH AH N 	d E s t 2 n e I S 2 n 
DESTINY 	D EH S T AH N IY 	d E s t 2 n i 
DESTROYER 	D IH S T R OY ER 	d I s t r U I E R 
DESTRUCTION 	D IH S T R AH K SH AH N 	d I s t r 2 k S 2 n 
DETAIL 	D IH T EY L 	d I t e I l 
DETECTION 	D IH T EH K SH AH N 	d I t E k S 2 n 
DETECTIVE 	D IH T EH K T IH V 	d I t E k t I v 
DETECTOR 	D IH T EH K T ER 	d I t E k t E R 
DETENTION 	D IH T EH N SH AH N 	d I t E n S 2 n 
DETERIORATION 	D IH T IH R IY ER EY SH AH N 	d I t I r i E R e I S 2 n 
DETERMINATION 	D IH T ER M AH N EY SH AH N 	d I t E R m 2 n e I S 2 n 
DETERMINER 	D IY T ER M AH N ER 	d i t E R m 2 n E R 
DETRACTOR 	D IY T R AE K T ER 	d i t r ae k t E R 
DEVELOPER 	D IH V EH L AH P ER 	d I v E l 2 p E R 
DEVELOPMENT 	D IH V EH L AH P M AH N T 	d I v E l 2 p m 2 n t 
DEVIATION 	D IY V IY EY SH AH N 	d i v i e I S 2 n 
DEVICE 	D IH V AY S 	d I v E I s 
DEVIL 	D EH V AH L 	d E v 2 l 
DIAPER 	D AY P ER 	d E I p E R 
DIARRHEA 	D AY ER IY AH 	d E I E R i 2 
DICTATOR 	D IH K T EY T ER 	d I k t e I t E R 
DICTATORSHIP 	D IH K T EY T ER SH IH P 	d I k t e I t E R S I p 
DICTIONARY 	D IH K SH AH N EH R IY 	d I k S 2 n E r i 
DIET 	D AY AH T 	d E I 2 t 
DIFFERENCE 	D IH F ER AH N S 	d I f E R 2 n s 
DIFFERENT 	D IH F ER AH N T 	d I f E R 2 n t 
DIFFERENTIAL 	D IH F ER EH N SH AH L 	d I f E R E n S 2 l 
DIFFICULTY 	D IH F AH K AH L T IY 	d I f 2 k 2 l t i 
DIGNITARY 	D IH G N AH T EH R IY 	d I g n 2 t E r i 
DILEMMA 	D IH L EH M AH 	d I l E m 2 
DILIGENCE 	D IH L IH JH AH N S 	d I l I dZ 2 n s 
DIME 	D AY M 	d E I m 
DINER 	D AY N ER 	d E I n E R 
DING 	D IH NG 	d I N 
DINING 	D AY N IH NG 	d E I n I N 
DINNER 	D IH N ER 	d I n E R 
DIOXIDE 	D AY AA K S AY D 	d E I a k s E I d 
DIP 	D IH P 	d I p 
DIPLOMACY 	D IH P L OW M AH S IY 	d I p l o U m 2 s i 
DIPLOMAT 	D IH P L AH M AE T 	d I p l 2 m ae t 
DIRECTION 	D ER EH K SH AH N 	d E R E k S 2 n 
DIRECTIVE 	D ER EH K T IH V 	d E R E k t I v 
DIRECTOR 	D ER EH K T ER 	d E R E k t E R 
DIRT 	D ER T 	d E R t 
DISABILITY 	D IH S AH B IH L IH T IY 	d I s 2 b I l I t i 
DISAPPEARANCE 	D IH S AH P IH R AH N S 	d I s 2 p I r 2 n s 
DISAPPOINTMENT 	D IH S AH P OY N T M AH N T 	d I s 2 p U I n t m 2 n t 
DISARMING 	D IH S AA R M IH NG 	d I s a r m I N 
DISASTER 	D IH Z AE S T ER 	d I z ae s t E R 
DISC 	D IH S K 	d I s k 
DISCHARGE 	D IH S CH AA R JH 	d I s tS a r dZ 
DISCIPLINE 	D IH S AH P L AH N 	d I s 2 p l 2 n 
DISCLAIMER 	D IH S K L EY M ER 	d I s k l e I m E R 
DISCLOSURE 	D IH S K L OW ZH ER 	d I s k l o U Z E R 
DISCO 	D IH S K OW 	d I s k o U 
DISCOMFORT 	D IH S K AH M F ER T 	d I s k 2 m f E R t 
DISCONTENT 	D IH S K AH N T EH N T 	d I s k 2 n t E n t 
DISCOUNT 	D IH S K AW N T 	d I s k E U n t 
DISCOVERY 	D IH S K AH V ER IY 	d I s k 2 v E R i 
DISCREDITING 	D IH S K R EH D AH T IH NG 	d I s k r E d 2 t I N 
DISCREPANCY 	D IH S K R EH P AH N S IY 	d I s k r E p 2 n s i 
DISCRETION 	D IH S K R EH SH AH N 	d I s k r E S 2 n 
DISCRIMINATION 	D IH S K R IH M AH N EY SH AH N 	d I s k r I m 2 n e I S 2 n 
DISCUSSION 	D IH S K AH SH AH N 	d I s k 2 S 2 n 
DISEASE 	D IH Z IY Z 	d I z i z 
DISGRACE 	D IH S G R EY S 	d I s g r e I s 
DISH 	D IH SH 	d I S 
DISINFORMATION 	D IH Z IH N F ER M EY SH AH N 	d I z I n f E R m e I S 2 n 
DISINTEGRATION 	D IH S IH N T AH G R EY SH AH N 	d I s I n t 2 g r e I S 2 n 
DISK 	D IH S K 	d I s k 
DISLIKE 	D IH S L AY K 	d I s l E I k 
DISMAY 	D IH S M EY 	d I s m e I 
DISPATCH 	D IH S P AE CH 	d I s p ae tS 
DISPERSAL 	D IH S P ER S AH L 	d I s p E R s 2 l 
DISPLAY 	D IH S P L EY 	d I s p l e I 
DISPOSAL 	D IH S P OW Z AH L 	d I s p o U z 2 l 
DISPUTE 	D IH S P Y UW T 	d I s p j u t 
DISREGARD 	D IH S R IH G AA R D 	d I s r I g a r d 
DISREPAIR 	D IH S R IH P EH R 	d I s r I p E r 
DISRUPTION 	D IH S R AH P SH AH N 	d I s r 2 p S 2 n 
DISSATISFACTION 	D IH S AE T IH S F AE K SH AH N 	d I s ae t I s f ae k S 2 n 
DISSEMINATION 	D IH S EH M AH N EY SH AH N 	d I s E m 2 n e I S 2 n 
DISSIPATION 	D IH S IH P EY SH AH N 	d I s I p e I S 2 n 
DISTANCE 	D IH S T AH N S 	d I s t 2 n s 
DISTINCTION 	D IH S T IH NG K SH AH N 	d I s t I N k S 2 n 
DISTRESS 	D IH S T R EH S 	d I s t r E s 
DISTRIBUTION 	D IH S T R AH B Y UW SH AH N 	d I s t r 2 b j u S 2 n 
DISTRICT 	D IH S T R IH K T 	d I s t r I k t 
DIVERSIFICATION 	D AY V ER S AH F AH K EY SH AH N 	d E I v E R s 2 f 2 k e I S 2 n 
DIVERSION 	D AY V ER ZH AH N 	d E I v E R Z 2 n 
DIVERSITY 	D IH V ER S IH T IY 	d I v E R s I t i 
DIVIDEND 	D IH V IH D EH N D 	d I v I d E n d 
DIVING 	D AY V IH NG 	d E I v I N 
DIVINITY 	D IH V IH N AH T IY 	d I v I n 2 t i 
DIVISION 	D IH V IH ZH AH N 	d I v I Z 2 n 
DIVORCE 	D IH V AO R S 	d I v O r s 
DOC 	D AA K 	d a k 
DOCK 	D AA K 	d a k 
DOCKING 	D AA K IH NG 	d a k I N 
DOCTOR 	D AA K T ER 	d a k t E R 
DOCUMENT 	D AA K Y AH M EH N T 	d a k j 2 m E n t 
DOCUMENTATION 	D AA K Y AH M EH N T EY SH AH N 	d a k j 2 m E n t e I S 2 n 
DOER 	D UW R 	d u r 
DOG 	D AO G 	d O g 
DOGWOOD 	D AO G W UH D 	d O g w U d 
DOLLAR 	D AA L ER 	d a l E R 
DOMAIN 	D OW M EY N 	d o U m e I n 
DOMESTIC 	D AH M EH S T IH K 	d 2 m E s t I k 
DOMINANCE 	D AA M AH N AH N S 	d a m 2 n 2 n s 
DONATION 	D OW N EY SH AH N 	d o U n e I S 2 n 
DONOR 	D OW N ER 	d o U n E R 
DOOR 	D AO R 	d O r 
DOORSTEP 	D AO R S T EH P 	d O r s t E p 
DOPE 	D OW P 	d o U p 
DOT 	D AA T 	d a t 
DOUBLE 	D AH B AH L 	d 2 b 2 l 
DOUBT 	D AW T 	d E U t 
DOUGH 	D OW 	d o U 
DOVE 	D AH V 	d 2 v 
DOWN 	D AW N 	d E U n 
DOWNFALL 	D AW N F AO L 	d E U n f O l 
DOWNLOAD 	D AW N L OW D 	d E U n l o U d 
DOWNLOADING 	D AW N L OW D IH NG 	d E U n l o U d I N 
DOWNSIZING 	D AW N S AY Z IH NG 	d E U n s E I z I N 
DOWNTOWN 	D AW N T AW N 	d E U n t E U n 
DOZEN 	D AH Z AH N 	d 2 z 2 n 
DRAFT 	D R AE F T 	d r ae f t 
DRAG 	D R AE G 	d r ae g 
DRAGON 	D R AE G AH N 	d r ae g 2 n 
DRAMA 	D R AA M AH 	d r a m 2 
DRAW 	D R AO 	d r O 
DRAWER 	D R AO R 	d r O r 
DRAWING 	D R AO IH NG 	d r O I N 
DREAM 	D R IY M 	d r i m 
DRESS 	D R EH S 	d r E s 
DRESSAGE 	D R EH S AA ZH 	d r E s a Z 
DRESSER 	D R EH S ER 	d r E s E R 
DRIFTWOOD 	D R IH F T W UH D 	d r I f t w U d 
DRILL 	D R IH L 	d r I l 
DRILLING 	D R IH L IH NG 	d r I l I N 
DRINK 	D R IH NG K 	d r I N k 
DRINKING 	D R IH NG K IH NG 	d r I N k I N 
DRIP 	D R IH P 	d r I p 
DRIVE 	D R AY V 	d r E I v 
DRIVER 	D R AY V ER 	d r E I v E R 
DRIVEWAY 	D R AY V W EY 	d r E I v w e I 
DRIVING 	D R AY V IH NG 	d r E I v I N 
DROP 	D R AA P 	d r a p 
DRUG 	D R AH G 	d r 2 g 
DRY 	D R AY 	d r E I 
DRYER 	D R AY ER 	d r E I E R 
DRYING 	D R AY IH NG 	d r E I I N 
DUALITY 	D UW AE L AH T IY 	d u ae l 2 t i 
DUCK 	D AH K 	d 2 k 
DUCT 	D AH K T 	d 2 k t 
DUDE 	D UW D 	d u d 
DUPLICITY 	D UW P L IH S IH T IY 	d u p l I s I t i 
DURABILITY 	D ER AH B IH L IH T IY 	d E R 2 b I l I t i 
DURATION 	D UH R EY SH AH N 	d U r e I S 2 n 
DURESS 	D UH R EH S 	d U r E s 
DUST 	D AH S T 	d 2 s t 
DUSTER 	D AH S T ER 	d 2 s t E R 
DUSTING 	D AH S T IH NG 	d 2 s t I N 
DUTY 	D UW T IY 	d u t i 
DWARF 	D W AO R F 	d w O r f 
DWELLER 	D W EH L ER 	d w E l E R 
DYNAMIC 	D AY N AE M IH K 	d E I n ae m I k 
DYSENTERY 	D IH S AH N T EH R IY 	d I s 2 n t E r i 
DYSPEPSIA 	D IH S EH P S IY AH 	d I s E p s i 2 
EAGLE 	IY G AH L 	i g 2 l 
EAR 	IY R 	i r 
EARMUFF 	IH R M AH F 	I r m 2 f 
EARNING 	ER N IH NG 	E R n I N 
EARRING 	IH R IH NG 	I r I N 
EARTH 	ER TH 	E R T 
EARTHQUAKE 	ER TH K W EY K 	E R T k w e I k 
EARTHWORM 	ER TH W ER M 	E R T w E R m 
EASE 	IY Z 	i z 
EAST 	IY S T 	i s t 
EAT 	IY T 	i t 
EATABLE 	IY T AH B AH L  	i t 2 b 2 l  
EATER 	IY T ER 	i t E R 
EATING 	IY T IH NG 	i t I N 
ECLIPSE 	IH K L IH P S 	I k l I p s 
ECOLOGIST 	IH K AA L AH JH IH S T 	I k a l 2 dZ I s t 
ECOLOGY 	IH K AA L AH JH IY 	I k a l 2 dZ i 
ECONOMICS 	EH K AH N AA M IH K S 	E k 2 n a m I k s 
ECONOMIST 	IH K AA N AH M IH S T 	I k a n 2 m I s t 
ECONOMY 	IH K AA N AH M IY 	I k a n 2 m i 
ECOSYSTEM 	IY K OW S IH S T AH M 	i k o U s I s t 2 m 
EDGE 	EH JH 	E dZ 
EDIT 	EH D AH T 	E d 2 t 
EDITING 	EH D AH T IH NG 	E d 2 t I N 
EDITOR 	EH D AH T ER 	E d 2 t E R 
EDITORIAL 	EH D AH T AO R IY AH L 	E d 2 t O r i 2 l 
EDUCATION 	EH JH AH K EY SH AH N 	E dZ 2 k e I S 2 n 
EDUCATOR 	EH JH AH K EY T ER 	E dZ 2 k e I t E R 
EFFECT 	IH F EH K T 	I f E k t 
EFFECTIVENESS 	IH F EH K T IH V N AH S 	I f E k t I v n 2 s 
EFFICIENCY 	IH F IH SH AH N S IY 	I f I S 2 n s i 
EFFORT 	EH F ER T 	E f E R t 
EGG 	EH G 	E g 
EGO 	IY G OW 	i g o U 
EIGHTY 	EY T IY 	e I t i 
ELDER 	EH L D ER 	E l d E R 
ELECTION 	IH L EH K SH AH N 	I l E k S 2 n 
ELECTRIC 	IH L EH K T R IH K 	I l E k t r I k 
ELECTRICITY 	IH L EH K T R IH S AH T IY 	I l E k t r I s 2 t i 
ELECTROLYTE 	AH L EH K T R AH L AY T 	2 l E k t r 2 l E I t 
ELECTRONICS 	IH L EH K T R AA N IH K S 	I l E k t r a n I k s 
ELEMENT 	EH L AH M AH N T 	E l 2 m 2 n t 
ELEPHANT 	EH L AH F AH N T 	E l 2 f 2 n t 
ELEVATOR 	EH L AH V EY T ER 	E l 2 v e I t E R 
ELIGIBILITY 	EH L IH JH AH B IH L IH T IY 	E l I dZ 2 b I l I t i 
ELK 	EH L K 	E l k 
EMAIL 	IY M EY L 	i m e I l 
EMBARRASSMENT 	IH M B EH R AH S M AH N T 	I m b E r 2 s m 2 n t 
EMBASSY 	EH M B AH S IY 	E m b 2 s i 
EMBRACE 	EH M B R EY S 	E m b r e I s 
EMBRYO 	EH M B R IY OW 	E m b r i o U 
EMERGENCY 	IH M ER JH AH N S IY 	I m E R dZ 2 n s i 
EMIRATE 	EH M ER AH T 	E m E R 2 t 
EMISSION 	IH M IH SH AH N 	I m I S 2 n 
EMOTION 	IH M OW SH AH N 	I m o U S 2 n 
EMPATHY 	EH M P AH TH IY 	E m p 2 T i 
EMPEROR 	EH M P ER ER 	E m p E R E R 
EMPLOYEE 	EH M P L OY IY 	E m p l U I i 
EMPLOYER 	EH M P L OY ER 	E m p l U I E R 
EMPLOYMENT 	EH M P L OY M AH N T 	E m p l U I m 2 n t 
EMPOWERMENT 	IH M P AW ER M AH N T 	I m p E U E R m 2 n t 
EMPTINESS 	EH M P T IY N AH S 	E m p t i n 2 s 
ENCHILADA 	EH N CH IH L AA D AH 	E n tS I l a d 2 
ENCLOSURE 	EH N K L OW ZH ER 	E n k l o U Z E R 
ENCOUNTER 	IH N K AW N T ER 	I n k E U n t E R 
ENCOURAGEMENT 	EH N K ER IH JH M AH N T 	E n k E R I dZ m 2 n t 
END 	EH N D 	E n d 
ENDANGERED 	EH N D EY N JH ER D 	E n d e I n dZ E R d 
ENDEAVOR 	IH N D EH V ER 	I n d E v E R 
ENDORSEMENT 	EH N D AO R S M AH N T 	E n d O r s m 2 n t 
ENEMY 	EH N AH M IY 	E n 2 m i 
ENERGY 	EH N ER JH IY 	E n E R dZ i 
ENFORCEMENT 	EH N F AO R S M AH N T 	E n f O r s m 2 n t 
ENGAGEMENT 	EH N G EY JH M AH N T 	E n g e I dZ m 2 n t 
ENGINE 	EH N JH AH N 	E n dZ 2 n 
ENGINEER 	EH N JH AH N IH R 	E n dZ 2 n I r 
ENGINEERING 	EH N JH AH N IH R IH NG 	E n dZ 2 n I r I N 
ENJOYMENT 	EH N JH OY M AH N T 	E n dZ U I m 2 n t 
ENLIGHTENMENT 	EH N L AY T AH N M AH N T 	E n l E I t 2 n m 2 n t 
ENQUIRY 	IH N K W AY R IY 	I n k w E I r i 
ENSEMBLE 	AA N S AA M B AH L 	a n s a m b 2 l 
ENTERED 	EH N T ER D 	E n t E R d 
ENTERING 	EH N T ER IH NG 	E n t E R I N 
ENTERPRISE 	EH N T ER P R AY Z 	E n t E R p r E I z 
ENTERTAINMENT 	EH N T ER T EY N M AH N T 	E n t E R t e I n m 2 n t 
ENTHUSIASM 	IH N TH UW Z IY AE Z AH M 	I n T u z i ae z 2 m 
ENTIRE 	IH N T AY ER 	I n t E I E R 
ENTITY 	EH N T AH T IY 	E n t 2 t i 
ENTOURAGE 	AA N T UH R AA ZH 	a n t U r a Z 
ENTRANCE 	EH N T R AH N S 	E n t r 2 n s 
ENTREATY 	EH N T R IY T IY 	E n t r i t i 
ENTRE 	IH N T AH R 	I n t 2 r 
ENTRY 	EH N T R IY 	E n t r i 
ENVELOPE 	EH N V AH L OW P 	E n v 2 l o U p 
ENVIRONMENT 	IH N V AY R AH N M AH N T 	I n v E I r 2 n m 2 n t 
ENVIRONMENTALIST 	IH N V AY R AH N M EH N T AH L IH S T 	I n v E I r 2 n m E n t 2 l I s t 
ENVOY 	EH N V OY 	E n v U I 
ENVY 	EH N V IY 	E n v i 
EPISODE 	EH P IH S OW D 	E p I s o U d 
EPITHET 	EH P AH TH EH T 	E p 2 T E t 
EPITOME 	IH P IH T AH M IY 	I p I t 2 m i 
EQUALITY 	IH K W AA L AH T IY 	I k w a l 2 t i 
EQUATION 	IH K W EY ZH AH N 	I k w e I Z 2 n 
EQUIPMENT 	IH K W IH P M AH N T 	I k w I p m 2 n t 
EQUITY 	EH K W AH T IY 	E k w 2 t i 
ERA 	EH R AH 	E r 2 
EROSION 	IH R OW ZH AH N 	I r o U Z 2 n 
ERROR 	EH R ER 	E r E R 
ESCALATION 	EH S K AH L EY SH AH N 	E s k 2 l e I S 2 n 
ESCALATOR 	EH S K AH L EY T ER 	E s k 2 l e I t E R 
ESCAPE 	IH S K EY P 	I s k e I p 
ESSENCE 	EH S AH N S 	E s 2 n s 
ESTABLISHMENT 	IH S T AE B L IH SH M AH N T 	I s t ae b l I S m 2 n t 
ESTIMATE 	EH S T AH M AH T 	E s t 2 m 2 t 
ETA 	EY T AH 	e I t 2 
ETHIC 	EH TH IH K 	E T I k 
ETHNICITY 	EH TH N IH S IH T IY 	E T n I s I t i 
ETIQUETTE 	EH T AH K AH T 	E t 2 k 2 t 
EVACUEE 	IH V AE K Y UW IY 	I v ae k j u i 
EVALUATION 	IH V AE L Y UW EY SH AH N 	I v ae l j u e I S 2 n 
EVENING 	IY V N IH NG 	i v n I N 
EVENT 	IH V EH N T 	I v E n t 
EVERYDAY 	EH V R IY D EY 	E v r i d e I 
EVIDENCE 	EH V AH D AH N S 	E v 2 d 2 n s 
EVIL 	IY V AH L 	i v 2 l 
EVOLUTION 	EH V AH L UW SH AH N 	E v 2 l u S 2 n 
EXAM 	IH G Z AE M 	I g z ae m 
EXAMINATION 	IH G Z AE M AH N EY SH AH N 	I g z ae m 2 n e I S 2 n 
EXAMPLE 	IH G Z AE M P AH L 	I g z ae m p 2 l 
EXCELLENCE 	EH K S AH L AH N S 	E k s 2 l 2 n s 
EXCEPTION 	IH K S EH P SH AH N 	I k s E p S 2 n 
EXCERPT 	EH K S ER P T 	E k s E R p t 
EXCHANGE 	IH K S CH EY N JH 	I k s tS e I n dZ 
EXCLUSION 	IH K S K L UW ZH AH N 	I k s k l u Z 2 n 
EXCUSE 	IH K S K Y UW S 	I k s k j u s 
EXECUTION 	EH K S AH K Y UW SH AH N 	E k s 2 k j u S 2 n 
EXECUTIVE 	IH G Z EH K Y AH T IH V 	I g z E k j 2 t I v 
EXERCISE 	EH K S ER S AY Z 	E k s E R s E I z 
EXHAUST 	IH G Z AO S T 	I g z O s t 
EXHAUSTION 	IH G Z AO S CH AH N 	I g z O s tS 2 n 
EXHIBIT 	IH G Z IH B IH T 	I g z I b I t 
EXHIBITION 	EH K S AH B IH SH AH N 	E k s 2 b I S 2 n 
EXISTENCE 	EH G Z IH S T AH N S 	E g z I s t 2 n s 
EXIT 	EH G Z IH T 	E g z I t 
EXPANSION 	IH K S P AE N SH AH N 	I k s p ae n S 2 n 
EXPECTANCY 	IH K S P EH K T AH N S IY 	I k s p E k t 2 n s i 
EXPECTATION 	EH K S P EH K T EY SH AH N 	E k s p E k t e I S 2 n 
EXPENSE 	IH K S P EH N S 	I k s p E n s 
EXPERIENCE 	IH K S P IH R IY AH N S 	I k s p I r i 2 n s 
EXPERT 	EH K S P ER T 	E k s p E R t 
EXPERTISE 	EH K S P ER T IY Z 	E k s p E R t i z 
EXPIRATION 	EH K S P ER EY SH AH N 	E k s p E R e I S 2 n 
EXPLANATION 	EH K S P L AH N EY SH AH N 	E k s p l 2 n e I S 2 n 
EXPLORATION 	EH K S P L ER EY SH AH N 	E k s p l E R e I S 2 n 
EXPLORER 	IH K S P L AO R ER 	I k s p l O r E R 
EXPLORING 	IH K S P L AO R IH NG 	I k s p l O r I N 
EXPLOSIVE 	IH K S P L OW S IH V 	I k s p l o U s I v 
EXPORTER 	IH K S P AO R T ER 	I k s p O r t E R 
EXPOSITION 	EH K S P AH Z IH SH AH N 	E k s p 2 z I S 2 n 
EXPOSURE 	IH K S P OW ZH ER 	I k s p o U Z E R 
EXPRESSION 	IH K S P R EH SH AH N 	I k s p r E S 2 n 
EXPRESSIONIST 	IH K S P R EH SH AH N AH S T 	I k s p r E S 2 n 2 s t 
EXPULSION 	IH K S P AH L SH AH N 	I k s p 2 l S 2 n 
EXTENSION 	IH K S T EH N SH AH N 	I k s t E n S 2 n 
EXTENT 	IH K S T EH N T 	I k s t E n t 
EXTERMINATION 	IH K S T ER M AH N EY SH AH N 	I k s t E R m 2 n e I S 2 n 
EXTERMINATOR 	IH K S T ER M AH N EY T ER 	I k s t E R m 2 n e I t E R 
EXTINCTION 	IH K S T IH NG K SH AH N 	I k s t I N k S 2 n 
EXTRA 	EH K S T R AH 	E k s t r 2 
EXTRACT 	EH K S T R AE K T 	E k s t r ae k t 
EXTRACTION 	EH K S T R AE K SH AH N 	E k s t r ae k S 2 n 
EXTRADITION 	EH K S T R AH D IH SH AH N 	E k s t r 2 d I S 2 n 
EXTREMIST 	IH K S T R IY M IH S T 	I k s t r i m I s t 
EYE 	AY 	E I 
EYELID 	AY L IH D 	E I l I d 
EYEWITNESS 	AY W IH T N AH S 	E I w I t n 2 s 
FABRIC 	F AE B R IH K 	f ae b r I k 
FABRICATION 	F AE B R IH K EY SH AH N 	f ae b r I k e I S 2 n 
FACE 	F EY S 	f e I s 
FACILITY 	F AH S IH L IH T IY 	f 2 s I l I t i 
FACT 	F AE K T 	f ae k t 
FACTION 	F AE K SH AH N 	f ae k S 2 n 
FACTOR 	F AE K T ER 	f ae k t E R 
FACTORY 	F AE K T ER IY 	f ae k t E R i 
FAILURE 	F EY L Y ER 	f e I l j E R 
FAITH 	F EY TH 	f e I T 
FAKE 	F EY K 	f e I k 
FALL 	F AO L 	f O l 
FALLIBILITY 	F AE L IH B IH L IH T IY 	f ae l I b I l I t i 
FALLING 	F AA L IH NG 	f a l I N 
FALLOUT 	F AO L AW T 	f O l E U t 
FALSEHOOD 	F AE L S HH UH D 	f ae l s h U d 
FAME 	F EY M 	f e I m 
FAMILIARITY 	F AH M IH L Y EH R AH T IY 	f 2 m I l j E r 2 t i 
FAMILY 	F AE M AH L IY 	f ae m 2 l i 
FAN 	F AE N 	f ae n 
FANATICISM 	F AH N AE T AH S IH Z AH M 	f 2 n ae t 2 s I z 2 m 
FANCY 	F AE N S IY 	f ae n s i 
FANTASY 	F AE N T AH S IY 	f ae n t 2 s i 
FARCE 	F AA R S 	f a r s 
FARE 	F EH R 	f E r 
FARM 	F AA R M 	f a r m 
FARMER 	F AA R M ER 	f a r m E R 
FARMLAND 	F AA R M L AE N D 	f a r m l ae n d 
FASHION 	F AE SH AH N 	f ae S 2 n 
FAT 	F AE T 	f ae t 
FATHER 	F AA DH ER 	f a D E R 
FAULT 	F AO L T 	f O l t 
FAVOR 	F EY V ER 	f e I v E R 
FAVORITE 	F EY V ER IH T 	f e I v E R I t 
FAX 	F AE K S 	f ae k s 
FEAR 	F IH R 	f I r 
FEAST 	F IY S T 	f i s t 
FEATHER 	F EH DH ER 	f E D E R 
FEATURE 	F IY CH ER 	f i tS E R 
FEDERATION 	F EH D ER EY SH AH N 	f E d E R e I S 2 n 
FEE 	F IY 	f i 
FEED 	F IY D 	f i d 
FEEDBACK 	F IY D B AE K 	f i d b ae k 
FEEDER 	F IY D ER 	f i d E R 
FEEDING 	F IY D IH NG 	f i d I N 
FEEL 	F IY L 	f i l 
FEELING 	F IY L IH NG 	f i l I N 
FEET 	F IY T 	f i t 
FELLOW 	F EH L OW 	f E l o U 
FEMALE 	F IY M EY L 	f i m e I l 
FEMINISM 	F EH M IH N IH Z AH M 	f E m I n I z 2 m 
FENCE 	F EH N S 	f E n s 
FERVOR 	F ER V ER 	f E R v E R 
FESTIVAL 	F EH S T AH V AH L 	f E s t 2 v 2 l 
FESTIVITY 	F EH S T IH V AH T IY 	f E s t I v 2 t i 
FETISHISM 	F EH T IH SH IH Z AH M 	f E t I S I z 2 m 
FEVER 	F IY V ER 	f i v E R 
FEW 	F Y UW 	f j u 
FICTION 	F IH K SH AH N 	f I k S 2 n 
FIELD 	F IY L D 	f i l d 
FIFTEENTH 	F IH F T IY N TH 	f I f t i n T 
FIGHT 	F AY T 	f E I t 
FIGHTER 	F AY T ER 	f E I t E R 
FIGHTING 	F AY T IH NG 	f E I t I N 
FIGURE 	F IH G Y ER 	f I g j E R 
FILE 	F AY L 	f E I l 
FILIGREE 	F IH L AH G R IY 	f I l 2 g r i 
FILING 	F AY L IH NG 	f E I l I N 
FILLER 	F IH L ER 	f I l E R 
FILM 	F IH L M 	f I l m 
FILMING 	F IH L M IH NG 	f I l m I N 
FILMMAKER 	F IH L M EY K ER 	f I l m e I k E R 
FILTER 	F IH L T ER 	f I l t E R 
FIN 	F IH N 	f I n 
FINANCE 	F AH N AE N S 	f 2 n ae n s 
FINANCING 	F AH N AE N S IH NG 	f 2 n ae n s I N 
FINCH 	F IH N CH 	f I n tS 
FIND 	F AY N D 	f E I n d 
FINDING 	F AY N D IH NG 	f E I n d I N 
FINGER 	F IH NG G ER 	f I N g E R 
FINISH 	F IH N IH SH 	f I n I S 
FIRE 	F AY ER 	f E I E R 
FIREPOWER 	F AY R P AW ER 	f E I r p E U E R 
FIREWALL 	F AY R W AA L 	f E I r w a l 
FIRM 	F ER M 	f E R m 
FIRST 	F ER S T 	f E R s t 
FISH 	F IH SH 	f I S 
FISHERY 	F IH SH ER IY 	f I S E R i 
FISHING 	F IH SH IH NG 	f I S I N 
FIST 	F IH S T 	f I s t 
FIT 	F IH T 	f I t 
FITNESS 	F IH T N AH S 	f I t n 2 s 
FITTER 	F IH T ER 	f I t E R 
FIVE 	F AY V  	f E I v  
FIX 	F IH K S 	f I k s 
FIXATION 	F IH K S EY SH AH N 	f I k s e I S 2 n 
FIXING 	F IH K S IH NG 	f I k s I N 
FIXTURE 	F IH K S CH ER 	f I k s tS E R 
FLAG 	F L AE G 	f l ae g 
FLAKE 	F L EY K 	f l e I k 
FLANK 	F L AE NG K 	f l ae N k 
FLASHLIGHT 	F L AE SH L AY T 	f l ae S l E I t 
FLAT 	F L AE T 	f l ae t 
FLATFISH 	F L AE T F IH SH 	f l ae t f I S 
FLAVOR 	F L EY V ER 	f l e I v E R 
FLAW 	F L AO 	f l O 
FLEA 	F L IY 	f l i 
FLEECE 	F L IY S 	f l i s 
FLEEING 	F L IY IH NG 	f l i I N 
FLEET 	F L IY T 	f l i t 
FLESH 	F L EH SH 	f l E S 
FLEXIBILITY 	F L EH K S AH B IH L AH T IY 	f l E k s 2 b I l 2 t i 
FLICKER 	F L IH K ER 	f l I k E R 
FLIER 	F L AY ER 	f l E I E R 
FLIGHT 	F L AY T 	f l E I t 
FLIPPING 	F L IH P IH NG 	f l I p I N 
FLOATING 	F L OW T IH NG 	f l o U t I N 
FLOCK 	F L AA K 	f l a k 
FLOOD 	F L AH D 	f l 2 d 
FLOODING 	F L AH D IH NG 	f l 2 d I N 
FLOOR 	F L AO R 	f l O r 
FLOORING 	F L AO R IH NG 	f l O r I N 
FLOPPING 	F L AA P IH NG 	f l a p I N 
FLORIST 	F L AA R IH S T 	f l a r I s t 
FLOW 	F L OW 	f l o U 
FLOWER 	F L AW ER 	f l E U E R 
FLUID 	F L UW AH D 	f l u 2 d 
FLY 	F L AY 	f l E I 
FLYER 	F L AY ER 	f l E I E R 
FOCUS 	F OW K AH S 	f o U k 2 s 
FOE 	F OW 	f o U 
FOLD 	F OW L D 	f o U l d 
FOLK 	F OW K 	f o U k 
FOLLOW 	F AA L OW 	f a l o U 
FOLLOWER 	F AA L OW ER 	f a l o U E R 
FOLLOWING 	F AA L OW IH NG 	f a l o U I N 
FOLLY 	F AA L IY 	f a l i 
FOOD 	F UW D 	f u d 
FOOL 	F UW L 	f u l 
FOOTBALL 	F UH T B AO L 	f U t b O l 
FOOTWEAR 	F UH T W EH R 	f U t w E r 
FORCE 	F AO R S 	f O r s 
FOREARM 	F AO R AA R M 	f O r a r m 
FORECAST 	F AO R K AE S T 	f O r k ae s t 
FOREGROUND 	F AO R G R AW N D 	f O r g r E U n d 
FOREIGNER 	F AO R AH N ER 	f O r 2 n E R 
FOREST 	F AO R AH S T 	f O r 2 s t 
FORESTRY 	F AO R AH S T R IY 	f O r 2 s t r i 
FORGER 	F AO R JH ER 	f O r dZ E R 
FORGIVENESS 	F ER G IH V N AH S 	f E R g I v n 2 s 
FORM 	F AO R M 	f O r m 
FORMALITY 	F AO R M AE L AH T IY 	f O r m ae l 2 t i 
FORMAT 	F AO R M AE T 	f O r m ae t 
FORMULA 	F AO R M Y AH L AH 	f O r m j 2 l 2 
FORUM 	F AO R AH M 	f O r 2 m 
FORWARDING 	F AO R W ER D IH NG 	f O r w E R d I N 
FOSSIL 	F AA S AH L 	f a s 2 l 
FOSTER 	F AA S T ER 	f a s t E R 
FOUNDATION 	F AW N D EY SH AH N 	f E U n d e I S 2 n 
FOUNDER 	F AW N D ER 	f E U n d E R 
FOUNTAIN 	F AW N T AH N 	f E U n t 2 n 
FOURTH 	F AO R TH 	f O r T 
FOX 	F AA K S 	f a k s 
FRACTION 	F R AE K SH AH N 	f r ae k S 2 n 
FRAGRANCE 	F R EY G R AH N S 	f r e I g r 2 n s 
FRAME 	F R EY M 	f r e I m 
FRANCHISE 	F R AE N CH AY Z 	f r ae n tS E I z 
FRAUD 	F R AO D 	f r O d 
FRAY 	F R EY 	f r e I 
FREEDOM 	F R IY D AH M 	f r i d 2 m 
FREEZE 	F R IY Z 	f r i z 
FREEZING 	F R IY Z IH NG 	f r i z I N 
FREIGHT 	F R EY T 	f r e I t 
FREIGHTER 	F R EY T ER 	f r e I t E R 
FREQUENCY 	F R IY K W AH N S IY 	f r i k w 2 n s i 
FRESCO 	F R EH S K OW 	f r E s k o U 
FRIDGE 	F R IH JH 	f r I dZ 
FRIEND 	F R EH N D 	f r E n d 
FRIENDLINESS 	F R EH N D L IY N IH S 	f r E n d l i n I s 
FRIENDSHIP 	F R EH N D SH IH P 	f r E n d S I p 
FRY 	F R AY  	f r E I 
FRITTER 	F R IH T ER 	f r I t E R 
FRONT 	F R AH N T 	f r 2 n t 
FROST 	F R AO S T 	f r O s t 
FROSTING 	F R AO S T IH NG 	f r O s t I N 
FRUIT 	F R UW T 	f r u t 
FRUSTRATION 	F R AH S T R EY SH AH N 	f r 2 s t r e I S 2 n 
FRY 	F R AY 	f r E I 
FUEL 	F Y UW AH L 	f j u 2 l 
FUGITIVE 	F Y UW JH AH T IH V 	f j u dZ 2 t I v 
FUME 	F Y UW M 	f j u m 
FUN 	F AH N 	f 2 n 
FUNCTION 	F AH NG K SH AH N 	f 2 N k S 2 n 
FUNCTIONALITY 	F AH NG K SH AH N AE L IH T IY 	f 2 N k S 2 n ae l I t i 
FUND 	F AH N D 	f 2 n d 
FUNDAMENTALIST 	F AH N D AH M EH N T AH L IH S T 	f 2 n d 2 m E n t 2 l I s t 
FUNDING 	F AH N D IH NG 	f 2 n d I N 
FUNERAL 	F Y UW N ER AH L 	f j u n E R 2 l 
FUNGUS 	F AH NG G AH S 	f 2 N g 2 s 
FUR 	F ER 	f E R 
FURNACE 	F ER N AH S 	f E R n 2 s 
FURNISHING 	F ER N IH SH IH NG  	f E R n I S I N  
FURNITURE 	F ER N IH CH ER 	f E R n I tS E R 
FUSE 	F Y UW Z 	f j u z 
FUSION 	F Y UW ZH AH N 	f j u Z 2 n 
FUSS 	F AH S 	f 2 s 
FUTURE 	F Y UW CH ER 	f j u tS E R 
GAIN 	G EY N 	g e I n 
GALL 	G AO L 	g O l 
GALLERY 	G AE L ER IY 	g ae l E R i 
GALLON 	G AE L AH N 	g ae l 2 n 
GAMBIT 	G AE M B IH T 	g ae m b I t 
GAMBLING 	G AE M B AH L IH NG 	g ae m b 2 l I N 
GAME 	G EY M 	g e I m 
GAMING 	G EY M IH NG 	g e I m I N 
GAMUT 	G AE M AH T 	g ae m 2 t 
GANG 	G AE NG 	g ae N 
GANGLAND 	G AE NG L AE N D 	g ae N l ae n d 
GAP 	G AE P 	g ae p 
GARAGE 	G ER AA ZH 	g E R a Z 
GARBAGE 	G AA R B IH JH 	g a r b I dZ 
GARDEN 	G AA R D AH N 	g a r d 2 n 
GARDENING 	G AA R D AH N IH NG 	g a r d 2 n I N 
GARLIC 	G AA R L IH K 	g a r l I k 
GARMENT 	G AA R M AH N T 	g a r m 2 n t 
GARNISH 	G AA R N IH SH 	g a r n I S 
GARRISON 	G AE R IH S AH N 	g ae r I s 2 n 
GAS 	G AE S 	g ae s 
GASH 	G AE SH 	g ae S 
GASP 	G AE S P 	g ae s p 
GATE 	G EY T 	g e I t 
GATHERING 	G AE DH ER IH NG 	g ae D E R I N 
GAY 	G EY 	g e I 
GEAR 	G IH R 	g I r 
GEARBOX 	G IH R B AA K S 	g I r b a k s 
GEE 	JH IY 	dZ i 
GEL 	JH EH L 	dZ E l 
GEM 	JH EH M 	dZ E m 
GENDER 	JH EH N D ER 	dZ E n d E R 
GENE 	JH IY N 	dZ i n 
GENEALOGY 	JH IY N IY AA L AH JH IY 	dZ i n i a l 2 dZ i 
GENERAL 	JH EH N ER AH L 	dZ E n E R 2 l 
GENERALIZATION 	JH EH N ER AH L IH Z EY SH AH N 	dZ E n E R 2 l I z e I S 2 n 
GENERATING 	JH EH N ER EY T IH NG 	dZ E n E R e I t I N 
GENERATION 	JH EH N ER EY SH AH N 	dZ E n E R e I S 2 n 
GENERATOR 	JH EH N ER EY T ER 	dZ E n E R e I t E R 
GENITAL 	JH EH N AH T AH L 	dZ E n 2 t 2 l  
GENIUS 	JH IY N Y AH S 	dZ i n j 2 s 
GENOCIDE 	JH EH N AH S AY D 	dZ E n 2 s E I d 
GENTLEMAN 	JH EH N T AH L M AH N 	dZ E n t 2 l m 2 n 
GERBIL 	JH AH R B AH L 	dZ 2 r b 2 l 
GESTURE 	JH EH S CH ER 	dZ E s tS E R 
GIANT 	JH AY AH N T 	dZ E I 2 n t 
GIFT 	G IH F T 	g I f t 
GINGER 	JH IH N JH ER 	dZ I n dZ E R 
GIRAFFE 	JH ER AE F 	dZ E R ae f 
GIRL 	G ER L 	g E R l 
GIRLFRIEND 	G ER L F R EH N D 	g E R l f r E n d 
GIVE 	G IH V 	g I v 
GIVEN 	G IH V AH N 	g I v 2 n 
GLAND 	G L AE N D 	g l ae n d 
GLASS 	G L AE S 	g l ae s 
GLITCH 	G L IH CH 	g l I tS 
GLOB 	G L AA B 	g l a b 
GLOBE 	G L OW B 	g l o U b 
GLOVE 	G L AH V 	g l 2 v 
GLOW 	G L OW 	g l o U 
GLUE 	G L UW 	g l u 
GLUT 	G L AH T 	g l 2 t 
GOAL 	G OW L 	g o U l 
GOAT 	G OW T 	g o U t 
GOD 	G AA D 	g a d 
GODDESS 	G AA D AH S 	g a d 2 s 
GODSEND 	G AA D S EH N D 	g a d s E n d 
GOLD 	G OW L D 	g o U l d 
GOLDEN 	G OW L D AH N 	g o U l d 2 n 
GOLF 	G AA L F 	g a l f 
GOLFER 	G AA L F ER 	g a l f E R 
GOOD 	G UH D 	g U d 
GOODNESS 	G UH D N AH S 	g U d n 2 s 
GORSE 	G AO R S 	g O r s 
GOUGING 	G AW JH IH NG 	g E U dZ I N 
GOUT 	G AW T 	g E U t 
GOVERNMENT 	G AH V ER N M AH N T 	g 2 v E R n m 2 n t 
GOVERNOR 	G AH V ER N ER 	g 2 v E R n E R 
GOWN 	G AW N 	g E U n 
GRAD 	G R AE D 	g r ae d 
GRADE 	G R EY D 	g r e I d 
GRADUATE 	G R AE JH AH W AH T 	g r ae dZ 2 w 2 t 
GRADUATION 	G R AE JH UW EY SH AH N 	g r ae dZ u e I S 2 n 
GRAIL 	G R EY L 	g r e I l 
GRAIN 	G R EY N 	g r e I n 
GRAM 	G R AE M 	g r ae m 
GRANDCHILD 	G R AE N D CH AY L D 	g r ae n d tS E I l d 
GRANDDAUGHTER 	G R AE N D AO T ER 	g r ae n d O t E R 
GRANDEUR 	G R AE N D UW R 	g r ae n d u r 
GRANDFATHER 	G R AE N D F AA DH ER 	g r ae n d f a D E R 
GRANDMA 	G R AE N D M AA 	g r ae n d m a 
GRANDMOTHER 	G R AE N D M AH DH ER 	g r ae n d m 2 D E R 
GRANDPARENT 	G R AE N D P EH R AH N T 	g r ae n d p E r 2 n t 
GRANDSON 	G R AE N D S AH N 	g r ae n d s 2 n 
GRANT 	G R AE N T 	g r ae n t 
GRANTING 	G R AE N T IH NG 	g r ae n t I N 
GRAPHIC 	G R AE F IH K 	g r ae f I k 
GRASS 	G R AE S 	g r ae s 
GRAVE 	G R EY V 	g r e I v 
GRAVEL 	G R AE V AH L 	g r ae v 2 l 
GRAVITY 	G R AE V AH T IY 	g r ae v 2 t i 
GRAVY 	G R EY V IY 	g r e I v i 
GRAY 	G R EY 	g r e I 
GREASE 	G R IY S 	g r i s 
GREATNESS 	G R EY T N AH S 	g r e I t n 2 s 
GREED 	G R IY D 	g r i d 
GREEN 	G R IY N 	g r i n 
GREENHOUSE 	G R IY N HH AW S 	g r i n h E U s 
GREETING 	G R IY T IH NG 	g r i t I N 
GRENADE 	G R AH N EY D 	g r 2 n e I d 
GREY 	G R EY 	g r e I 
GRID 	G R IH D 	g r I d 
GRILL 	G R IH L 	g r I l 
GRINDER 	G R AY N D ER 	g r E I n d E R 
GRINDSTONE 	G R AY N D S T OW N 	g r E I n d s t o U n 
GRIP 	G R IH P 	g r I p 
GRIST 	G R IH S T 	g r I s t 
GROCERY 	G R OW S ER IY 	g r o U s E R i 
GROSS 	G R OW S 	g r o U s 
GROUND 	G R AW N D 	g r E U n d 
GROUP 	G R UW P 	g r u p 
GROWTH 	G R OW TH 	g r o U T 
GUACAMOLE 	G W AA K AH M OW L IY 	g w a k 2 m o U l i 
GUARANTEE 	G EH R AH N T IY 	g E r 2 n t i 
GUARANTY 	G EH R AH N T IY 	g E r 2 n t i 
GUARD 	G AA R D 	g a r d 
GUARDIAN 	G AA R D IY AH N 	g a r d i 2 n 
GUARDSMAN 	G AA R D Z M AE N 	g a r d z m ae n 
GUERILLA 	G ER IH L AH 	g E R I l 2 
GUERRILLA 	G ER IH L AH 	g E R I l 2 
GUESS 	G EH S 	g E s 
GUEST 	G EH S T 	g E s t 
GUIDANCE 	G AY D AH N S 	g E I d 2 n s 
GUIDE 	G AY D 	g E I d 
GUIDELINE 	G AY D L AY N 	g E I d l E I n 
GUILD 	G IH L D 	g I l d 
GUILT 	G IH L T 	g I l t 
GUILTY 	G IH L T IY 	g I l t i 
GUINEA 	G IH N IY 	g I n i 
GUITAR 	G IH T AA R 	g I t a r 
GUITARIST 	G IH T AA R IH S T 	g I t a r I s t 
GULF 	G AH L F 	g 2 l f 
GUN 	G AH N 	g 2 n 
GUNMAN 	G AH N M AH N 	g 2 n m 2 n 
GUNPOWDER 	G AH N P AW D ER 	g 2 n p E U d E R 
GUT 	G AH T 	g 2 t 
GUY 	G AY 	g E I 
GYM 	JH IH M 	dZ I m 
GYMNASIUM 	JH IH M N EY Z IY AH M 	dZ I m n e I z i 2 m 
HABIT 	HH AE B AH T 	h ae b 2 t 
HABITAT 	HH AE B AH T AE T 	h ae b 2 t ae t 
HABITATION 	HH AE B AH T EY SH AH N 	h ae b 2 t e I S 2 n 
HACKLES 	HH AE K AH L Z 	h ae k 2 l z 
HADDOCK 	HH AE D AH K 	h ae d 2 k 
HAEMORRHAGE 	HH IY M AO R AH JH 	h i m O r 2 dZ 
HAILSTORM 	HH EY L S T AO R M 	h e I l s t O r m 
HAIR 	HH EH R 	h E r 
HAIRCUT 	HH EH R K AH T 	h E r k 2 t 
HAIRDRESSER 	HH EH R D R EH S ER 	h E r d r E s E R 
HAIRSTYLIST 	HH EH R S T AY L IH S T 	h E r s t E I l I s t 
HALF 	HH AE F 	h ae f 
HALIBUT 	HH AE L AH B AH T 	h ae l 2 b 2 t 
HALL 	HH AO L 	h O l 
HALLWAY 	HH AO L W EY 	h O l w e I 
HALT 	HH AO L T 	h O l t 
HAM 	HH AE M 	h ae m 
HAMMER 	HH AE M ER 	h ae m E R 
HAMMOCK 	HH AE M AH K 	h ae m 2 k 
HAMSTER 	HH AE M S T ER 	h ae m s t E R 
HAND 	HH AE N D 	h ae n d 
HANDBAG 	HH AE N D B AE G 	h ae n d b ae g 
HANDCRAFT 	HH AE N D K R AE F T 	h ae n d k r ae f t 
HANDFUL 	HH AE N D F UH L 	h ae n d f U l 
HANDICAP 	HH AE N D IY K AE P 	h ae n d i k ae p 
HANDLE 	HH AE N D AH L 	h ae n d 2 l 
HANDLING 	HH AE N D L IH NG 	h ae n d l I N 
HANGAR 	HH AE NG ER 	h ae N E R 
HANGING 	HH AE NG IH NG 	h ae N I N 
HANGOUT 	HH AE NG AW T 	h ae N E U t 
HAPPINESS 	HH AE P IY N AH S 	h ae p i n 2 s 
HARDLINER 	HH AA R D L AY N ER 	h a r d l E I n E R 
HARDNESS 	HH AA R D N AH S 	h a r d n 2 s 
HARDSHIP 	HH AA R D SH IH P 	h a r d S I p 
HARDWARE 	HH AA R D W EH R 	h a r d w E r 
HARM 	HH AA R M 	h a r m 
HARMONY 	HH AA R M AH N IY 	h a r m 2 n i 
HARNESS 	HH AA R N AH S 	h a r n 2 s 
HASH 	HH AE SH 	h ae S 
HASSLE 	HH AE S AH L 	h ae s 2 l 
HASTE 	HH EY S T 	h e I s t 
HAT 	HH AE T 	h ae t 
HATE 	HH EY T 	h e I t 
HATRED 	HH EY T R AH D 	h e I t r 2 d 
HAULING 	HH AO L IH NG 	h O l I N 
HAVEN 	HH EY V AH N 	h e I v 2 n 
HAVOC 	HH AE V AH K 	h ae v 2 k 
HAY 	HH EY 	h e I 
HAZARD 	HH AE Z ER D 	h ae z E R d 
HEAD 	HH EH D 	h E d 
HEADBOARD 	HH EH D B AO R D 	h E d b O r d 
HEADER 	HH EH D ER 	h E d E R 
HEADING 	HH EH D IH NG 	h E d I N 
HEADLINE 	HH EH D L AY N 	h E d l E I n 
HEALING 	HH IY L IH NG 	h i l I N 
HEALTH 	HH EH L TH 	h E l T 
HEARING 	HH IY R IH NG 	h i r I N 
HEART 	HH AA R T 	h a r t 
HEAT 	HH IY T 	h i t 
HEATER 	HH IY T ER 	h i t E R 
HEATHER 	HH EH DH ER 	h E D E R 
HEATING 	HH IY T IH NG 	h i t I N 
HEAVEN 	HH EH V AH N 	h E v 2 n 
HEAVYWEIGHT 	HH EH V IY W EY T 	h E v i w e I t 
HECK 	HH EH K 	h E k 
HEDGE 	HH EH JH 	h E dZ 
HEDGING 	HH EH JH IH NG 	h E dZ I N 
HEED 	HH IY D 	h i d 
HEEL 	HH IY L 	h i l 
HEIFER 	HH AY F ER 	h E I f E R 
HEIGHT 	HH AY T 	h E I t 
HELICOPTER 	HH EH L IH K AA P T ER 	h E l I k a p t E R 
HELL 	HH EH L 	h E l 
HELP 	HH EH L P 	h E l p 
HELPER 	HH EH L P ER 	h E l p E R 
HEMISPHERE 	HH EH M IH S F IH R 	h E m I s f I r 
HEN 	HH EH N 	h E n 
HERB 	ER B 	E R b 
HERBALIST 	ER B AH L IH S T 	E R b 2 l I s t 
HERD 	HH ER D 	h E R d 
HERDING 	HH ER D IH NG 	h E R d I N 
HERITAGE 	HH EH R AH T AH JH 	h E r 2 t 2 dZ 
HERNIA 	HH ER N IY AH 	h E R n i 2 
HERO 	HH IH R OW 	h I r o U 
HERPES 	HH ER P IY Z 	h E R p i z 
HERRING 	HH EH R IH NG 	h E r I N 
HESITATION 	HH EH Z AH T EY SH AH N 	h E z 2 t e I S 2 n 
HEYDAY 	HH EY D EY 	h e I d e I 
HIATUS 	HH AY EY T AH S 	h E I e I t 2 s 
HIBERNATION 	HH AY B ER N EY SH AH N 	h E I b E R n e I S 2 n 
HIDE 	HH AY D 	h E I d 
HIDEOUT 	HH AY D AW T 	h E I d E U t 
HIDING 	HH AY D IH NG 	h E I d I N 
HIERARCHY 	HH AY ER AA R K IY 	h E I E R a r k i 
HIGH 	HH AY 	h E I 
HIGHLIGHT 	HH AY L AY T 	h E I l E I t 
HIGHWAY 	HH AY W EY 	h E I w e I 
HIJACKER 	HH AY JH AE K ER 	h E I dZ ae k E R 
HIKE 	HH AY K 	h E I k 
HILL 	HH IH L 	h I l 
HINDSIGHT 	HH AY N D S AY T 	h E I n d s E I t 
HINGE 	HH IH N JH 	h I n dZ 
HINT 	HH IH N T 	h I n t 
HIPPIE 	HH IH P IY 	h I p i 
HIPPY 	HH IH P IY 	h I p i 
HISS 	HH IH S 	h I s 
HISSING 	HH IH S IH NG 	h I s I N 
HISTORIAN 	HH IH S T AO R IY AH N 	h I s t O r i 2 n 
HISTORY 	HH IH S T ER IY 	h I s t E R i 
HIT 	HH IH T 	h I t 
HITCH 	HH IH CH 	h I tS 
HOAX 	HH OW K S 	h o U k s 
HOBBY 	HH AA B IY 	h a b i 
HOCKEY 	HH AA K IY 	h a k i 
HOLD 	HH OW L D 	h o U l d 
HOLDER 	HH OW L D ER 	h o U l d E R 
HOLDING 	HH OW L D IH NG 	h o U l d I N 
HOLE 	HH OW L 	h o U l 
HOLIDAY 	HH AA L AH D EY 	h a l 2 d e I 
HOLIDAYING 	HH AA L AH D EY IH NG 	h a l 2 d e I I N 
HOLOCAUST 	HH AO L AH K AO S T 	h O l 2 k O s t 
HOME 	HH OW M 	h o U m 
HOMELAND 	HH OW M L AE N D 	h o U m l ae n d 
HOMEPAGE 	HH OW M P EY JH 	h o U m p e I dZ 
HOMEWORK 	HH OW M W ER K 	h o U m w E R k 
HOMOSEXUAL 	HH OW M OW S EH K SH UW AH L 	h o U m o U s E k S u 2 l 
HOMOSEXUALITY 	HH OW M OW S EH K SH UW AE L AH T IY 	h o U m o U s E k S u ae l 2 t i 
HONESTY 	AA N AH S T IY 	a n 2 s t i 
HONEY 	HH AH N IY 	h 2 n i 
HONEYMOON 	HH AH N IY M UW N 	h 2 n i m u n 
HONOR 	AA N ER 	a n E R 
HOOD 	HH UH D 	h U d 
HOOF 	HH UW F 	h u f 
HOOKER 	HH UH K ER 	h U k E R 
HOPE 	HH OW P 	h o U p 
HOPELESSNESS 	HH OW P L AH S N AH S 	h o U p l 2 s n 2 s 
HORIZON 	HH ER AY Z AH N 	h E R E I z 2 n 
HORN 	HH AO R N 	h O r n 
HORNET 	HH AO R N IH T 	h O r n I t 
HORROR 	HH AO R ER 	h O r E R 
HORSE 	HH AO R S 	h O r s 
HOSE 	HH OW Z 	h o U z 
HOSPITAL 	HH AA S P IH T AH L 	h a s p I t 2 l 
HOSPITALITY 	HH AA S P AH T AE L AH T IY 	h a s p 2 t ae l 2 t i 
HOST 	HH OW S T 	h o U s t 
HOSTAGE 	HH AA S T IH JH 	h a s t I dZ 
HOSTESS 	HH OW S T AH S 	h o U s t 2 s 
HOSTILITY 	HH AA S T IH L AH T IY 	h a s t I l 2 t i 
HOSTING 	HH OW S T IH NG 	h o U s t I N 
HOTEL 	HH OW T EH L 	h o U t E l 
HOTHEAD 	HH AA T HH EH D 	h a t h E d 
HOUR 	AW ER 	E U E R 
HOUSE 	HH AW S 	h E U s 
HOUSEHOLD 	HH AW S HH OW L D 	h E U s h o U l d 
HOUSING 	HH AW Z IH NG 	h E U z I N 
HOW 	HH AW 	h E U 
HUB 	HH AH B 	h 2 b 
HUG 	HH AH G 	h 2 g 
HULL 	HH AH L 	h 2 l 
HUMAN 	HH Y UW M AH N 	h j u m 2 n 
HUMANIST 	HH Y UW M AH N IH S T 	h j u m 2 n I s t 
HUMANITY 	HH Y UW M AE N IH T IY 	h j u m ae n I t i 
HUMILIATION 	HH Y UW M IH L IY EY SH AH N 	h j u m I l i e I S 2 n 
HUMOR 	HH Y UW M ER 	h j u m E R 
HUNDRED 	HH AH N D R AH D 	h 2 n d r 2 d 
HUNGER 	HH AH NG G ER 	h 2 N g E R 
HUNK 	HH AH NG K 	h 2 N k 
HUNT 	HH AH N T 	h 2 n t 
HUNTER 	HH AH N T ER 	h 2 n t E R 
HURDLE 	HH ER D AH L 	h E R d 2 l 
HURRY 	HH ER IY 	h E R i 
HUSBAND 	HH AH Z B AH N D 	h 2 z b 2 n d 
HUSTLE 	HH AH S AH L 	h 2 s 2 l 
HUTCH 	HH AH CH 	h 2 tS 
HYBRID 	HH AY B R AH D 	h E I b r 2 d 
HYGIENE 	HH AY JH IY N 	h E I dZ i n 
HYPE 	HH AY P 	h E I p 
HYPOCRISY 	HH IH P AA K R AH S IY 	h I p a k r 2 s i 
HYSTERIA 	HH IH S T EH R IY AH 	h I s t E r i 2 
ICE 	AY S 	E I s 
ICEBERG 	AY S B ER G 	E I s b E R g 
ICING 	AY S IH NG 	E I s I N 
ICON 	AY K AA N 	E I k a n 
IDEA 	AY D IY AH 	E I d i 2 
IDEAL 	AY D IY L 	E I d i l 
IDENTIFICATION 	AY D EH N T AH F AH K EY SH AH N 	E I d E n t 2 f 2 k e I S 2 n 
IDENTITY 	AY D EH N T AH T IY 	E I d E n t 2 t i 
IDEOLOGY 	AY D IY AA L AH JH IY 	E I d i a l 2 dZ i 
IDIOT 	IH D IY AH T 	I d i 2 t 
IGNORAMUS 	IH G N ER EY M AH S 	I g n E R e I m 2 s 
IGNORANCE 	IH G N ER AH N S 	I g n E R 2 n s 
ILK 	IH L K 	I l k 
ILLEGAL 	IH L IY G AH L 	I l i g 2 l 
ILLNESS 	IH L N AH S 	I l n 2 s 
ILLUSION 	IH L UW ZH AH N 	I l u Z 2 n 
IMAGE 	IH M AH JH 	I m 2 dZ 
IMAGINATION 	IH M AE JH AH N EY SH AH N 	I m ae dZ 2 n e I S 2 n 
IMBALANCE 	IH M B AE L AH N S 	I m b ae l 2 n s 
IMMIGRANT 	IH M AH G R AH N T 	I m 2 g r 2 n t 
IMMIGRATION 	IH M AH G R EY SH AH N 	I m 2 g r e I S 2 n 
IMMUNITY 	IH M Y UW N AH T IY 	I m j u n 2 t i 
IMPACT 	IH M P AE K T 	I m p ae k t 
IMPASSE 	IH M P AE S 	I m p ae s 
IMPLEMENTATION 	IH M P L AH M EH N T EY SH AH N 	I m p l 2 m E n t e I S 2 n 
IMPLICATION 	IH M P L AH K EY SH AH N 	I m p l 2 k e I S 2 n 
IMPORTANCE 	IH M P AO R T AH N S 	I m p O r t 2 n s 
IMPOSTER 	IH M P AO S T ER 	I m p O s t E R 
IMPRESSION 	IH M P R EH SH AH N 	I m p r E S 2 n 
IMPRISONMENT 	IH M P R IH Z AH N M AH N T 	I m p r I z 2 n m 2 n t 
IMPROVEMENT 	IH M P R UW V M AH N T 	I m p r u v m 2 n t 
INABILITY 	IH N AH B IH L IH T IY 	I n 2 b I l I t i 
INCENTIVE 	IH N S EH N T IH V 	I n s E n t I v 
INCEPTION 	IH N S EH P SH AH N 	I n s E p S 2 n 
INCH 	IH N CH 	I n tS 
INCIDENT 	IH N S AH D AH N T 	I n s 2 d 2 n t 
INCITEMENT 	IH N S AY T M AH N T 	I n s E I t m 2 n t 
INCLUSION 	IH N K L UW ZH AH N 	I n k l u Z 2 n 
INCOME 	IH N K AH M 	I n k 2 m 
INCOMPETENCE 	IH N K AA M P AH T AH N S 	I n k a m p 2 t 2 n s 
INCONSISTENCY 	IH N K AH N S IH S T AH N S IY 	I n k 2 n s I s t 2 n s i 
INCREASE 	IH N K R IY S 	I n k r i s 
INCREDULITY 	IH N K R AH D UW L IH T IY 	I n k r 2 d u l I t i 
INCUBATION 	IH NG K Y UW B EY SH AH N 	I N k j u b e I S 2 n 
INDEX 	IH N D EH K S 	I n d E k s 
INDICATION 	IH N D AH K EY SH AH N 	I n d 2 k e I S 2 n 
INDICATOR 	IH N D AH K EY T ER 	I n d 2 k e I t E R 
INDIGNITY 	IH N D IH G N AH T IY 	I n d I g n 2 t i 
INDIVIDUAL 	IH N D AH V IH JH AH W AH L 	I n d 2 v I dZ 2 w 2 l 
INDUSTRIALIST 	IH N D AH S T R IY AH L IH S T 	I n d 2 s t r i 2 l I s t 
INDUSTRY 	IH N D AH S T R IY 	I n d 2 s t r i 
INEQUITY 	IH N EH K W AH T IY 	I n E k w 2 t i 
INFANT 	IH N F AH N T 	I n f 2 n t 
INFANTRY 	IH N F AH N T R IY 	I n f 2 n t r i 
INFECTION 	IH N F EH K SH AH N 	I n f E k S 2 n 
INFERIORITY 	IH N F IH R IY AO R IH T IY 	I n f I r i O r I t i 
INFERTILITY 	IH N F ER T IH L IH T IY 	I n f E R t I l I t i 
INFIDEL 	IH N F IH D EH L 	I n f I d E l 
INFILTRATOR 	IH N F IH L T R EY T ER 	I n f I l t r e I t E R 
INFINITY 	IH N F IH N IH T IY 	I n f I n I t i 
INFLATION 	IH N F L EY SH AH N 	I n f l e I S 2 n 
INFLUENCE 	IH N F L UW AH N S 	I n f l u 2 n s 
INFLUX 	IH N F L AH K S 	I n f l 2 k s 
INFO 	IH N F OW 	I n f o U 
INFORMATION 	IH N F AO R M EY SH AH N 	I n f O r m e I S 2 n 
INFRASTRUCTURE 	IH N F R AH S T R AH K CH ER 	I n f r 2 s t r 2 k tS E R 
INGREDIENT 	IH N G R IY D IY AH N T 	I n g r i d i 2 n t 
INITIAL 	IH N IH SH AH L 	I n I S 2 l 
INITIATIVE 	IH N IH SH AH T IH V 	I n I S 2 t I v 
INJECTION 	IH N JH EH K SH AH N 	I n dZ E k S 2 n 
INJURY 	IH N JH ER IY 	I n dZ E R i 
INJUSTICE 	IH N JH AH S T IH S 	I n dZ 2 s t I s 
INK 	IH NG K 	I N k 
INN 	IH N 	I n 
INNKEEPER 	IH N K IY P ER 	I n k i p E R 
INNOCENT 	IH N AH S AH N T 	I n 2 s 2 n t 
INNOVATION 	IH N AH V EY SH AH N 	I n 2 v e I S 2 n 
INPUT 	IH N P UH T 	I n p U t 
INQUIRE 	IH N K W AY R 	I n k w E I r 
INQUIRY 	IH N K W AY R IY 	I n k w E I r i 
INSECT 	IH N S EH K T 	I n s E k t 
INSERT 	IH N S ER T 	I n s E R t 
INSIDE 	IH N S AY D 	I n s E I d 
INSIDER 	IH N S AY D ER 	I n s E I d E R 
INSIGHT 	IH N S AY T 	I n s E I t 
INSOMNIA 	IH N S AA M N IY AH 	I n s a m n i 2 
INSPECTION 	IH N S P EH K SH AH N 	I n s p E k S 2 n 
INSPECTOR 	IH N S P EH K T ER 	I n s p E k t E R 
INSTABILITY 	IH N S T AH B IH L IH T IY 	I n s t 2 b I l I t i 
INSTALLATION 	IH N S T AH L EY SH AH N 	I n s t 2 l e I S 2 n 
INSTANCE 	IH N S T AH N S 	I n s t 2 n s 
INSTANT 	IH N S T AH N T 	I n s t 2 n t 
INSTINCT 	IH N S T IH NG K T 	I n s t I N k t 
INSTITUTION 	IH N S T IH T UW SH AH N 	I n s t I t u S 2 n 
INSTRUCTION 	IH N S T R AH K SH AH N 	I n s t r 2 k S 2 n 
INSTRUCTOR 	IH N S T R AH K T ER 	I n s t r 2 k t E R 
INSTRUMENTATION 	IH N S T R AH M EH N T EY SH AH N 	I n s t r 2 m E n t e I S 2 n 
INSULATION 	IH N S AH L EY SH AH N 	I n s 2 l e I S 2 n 
INSULT 	IH N S AH L T 	I n s 2 l t 
INSURANCE 	IH N SH UH R AH N S 	I n S U r 2 n s 
INSURER 	IH N SH UH R ER 	I n S U r E R 
INSURGENCY 	IH N S ER JH AH N S IY 	I n s E R dZ 2 n s i 
INSURGENT 	IH N S ER JH AH N T 	I n s E R dZ 2 n t 
INSURGENTS 	IH N S ER JH AH N T S 	I n s E R dZ 2 n t s 
INTAKE 	IH N T EY K 	I n t e I k 
INTEGRITY 	IH N T EH G R AH T IY 	I n t E g r 2 t i 
INTELLECT 	IH N T AH L EH K T 	I n t 2 l E k t 
INTELLECTUAL 	IH N T AH L EH K CH UW AH L 	I n t 2 l E k tS u 2 l 
INTELLIGENCE 	IH N T EH L AH JH AH N S 	I n t E l 2 dZ 2 n s 
INTENT 	IH N T EH N T 	I n t E n t 
INTENTION 	IH N T EH N CH AH N 	I n t E n tS 2 n 
INTERACTION 	IH N T ER AE K SH AH N 	I n t E R ae k S 2 n 
INTERCEPT 	IH N T ER S EH P T 	I n t E R s E p t 
INTERCEPTION 	IH N T ER S EH P SH AH N 	I n t E R s E p S 2 n 
INTERCEPTOR 	IH N T ER S EH P T ER 	I n t E R s E p t E R 
INTERCONNECT 	IH N T ER K AH N EH K T 	I n t E R k 2 n E k t 
INTERCOURSE 	IH N T ER K AO R S 	I n t E R k O r s 
INTEREST 	IH N T AH R EH S T 	I n t 2 r E s t 
INTERESTING 	IH N T AH R EH S T IH NG 	I n t 2 r E s t I N 
INTERFACE 	IH N T ER F EY S 	I n t E R f e I s 
INTERFERENCE 	IH N T ER F IH R AH N S 	I n t E R f I r 2 n s 
INTERMEDIARY 	IH N ER M IY D IY EH R IY 	I n E R m i d i E r i 
INTERN 	IH N T ER N 	I n t E R n 
INTERNET 	IH N T ER N EH T 	I n t E R n E t 
INTERROGATION 	IH N T EH R AH G EY SH AH N 	I n t E r 2 g e I S 2 n 
INTERROGATOR 	IH N T EH R AH G EY T ER 	I n t E r 2 g e I t E R 
INTERVENTION 	IH N T ER V EH N SH AH N 	I n t E R v E n S 2 n 
INTERVIEW 	IH N T ER V Y UW 	I n t E R v j u 
INTERVIEWER 	IH N T ER V Y UW ER 	I n t E R v j u E R 
INTESTINE 	IH N T EH S T AH N 	I n t E s t 2 n 
INTIMACY 	IH N T AH M AH S IY 	I n t 2 m 2 s i 
INTO 	IH N T UW 	I n t u 
INTOLERANCE 	IH N T AA L ER AH N S 	I n t a l E R 2 n s 
INTRIGUE 	IH N T R IY G 	I n t r i g 
INTRODUCTION 	IH N T R AH D AH K SH AH N 	I n t r 2 d 2 k S 2 n 
INTROSPECTION 	IH N T R AH S P EH K SH AH N 	I n t r 2 s p E k S 2 n 
INTRUDER 	IH N T R UW D ER 	I n t r u d E R 
INTRUSION 	IH N T R UW ZH AH N 	I n t r u Z 2 n 
INTUITION 	IH N T UW IH SH AH N 	I n t u I S 2 n 
INVASION 	IH N V EY ZH AH N 	I n v e I Z 2 n 
INVENTION 	IH N V EH N SH AH N 	I n v E n S 2 n 
INVENTORY 	IH N V AH N T AO R IY 	I n v 2 n t O r i 
INVERSION 	IH N V ER ZH AH N 	I n v E R Z 2 n 
INVESTIGATION 	IH N V EH S T AH G EY SH AH N 	I n v E s t 2 g e I S 2 n 
INVESTIGATOR 	IH N V EH S T AH G EY T ER 	I n v E s t 2 g e I t E R 
INVESTMENT 	IH N V EH S T M AH N T 	I n v E s t m 2 n t 
INVESTOR 	IH N V EH S T ER 	I n v E s t E R 
INVITATION 	IH N V IH T EY SH AH N 	I n v I t e I S 2 n 
INVOICE 	IH N V OY S 	I n v U I s 
INVOICING 	IH N V OY S IH NG 	I n v U I s I N 
INVOLVEMENT 	IH N V AA L V M AH N T 	I n v a l v m 2 n t 
IRON 	AY ER N 	E I E R n 
IRONY 	AY R AH N IY 	E I r 2 n i 
IRREGULARITY 	IH R EH G Y AH L EH R AH T IY 	I r E g j 2 l E r 2 t i 
IRRITATION 	IH R IH T EY SH AH N 	I r I t e I S 2 n 
ISLAND 	AY L AH N D 	E I l 2 n d 
ISSUE 	IH SH UW 	I S u 
ITEM 	AY T AH M 	E I t 2 m 
ITINERARY 	AY T IH N ER EH R IY 	E I t I n E R E r i 
JACK 	JH AE K 	dZ ae k 
JACKET 	JH AE K AH T 	dZ ae k 2 t 
JAIL 	JH EY L 	dZ e I l 
JAR 	JH AA R 	dZ a r 
JAW 	JH AO 	dZ O 
JAZZ 	JH AE Z 	dZ ae z 
JERK 	JH ER K 	dZ E R k 
JESTER 	JH EH S T ER 	dZ E s t E R 
JET 	JH EH T 	dZ E t 
JEWELRY 	JH UW AH L R IY 	dZ u 2 l r i 
JIHAD 	JH IY HH AA D 	dZ i h a d 
JIMMY 	JH IH M IY 	dZ I m i 
JOB 	JH AA B 	dZ a b 
JOG 	JH AA G 	dZ a g 
JOINT 	JH OY N T 	dZ U I n t 
JOKE 	JH OW K 	dZ o U k 
JOURNAL 	JH ER N AH L 	dZ E R n 2 l 
JOURNALIST 	JH ER N AH L AH S T 	dZ E R n 2 l 2 s t 
JOURNEY 	JH ER N IY 	dZ E R n i 
JOY 	JH OY 	dZ U I 
JOYSTICK 	JH OY S T IH K 	dZ U I s t I k 
JUDGE 	JH AH JH 	dZ 2 dZ 
JUDGEMENT 	JH AH JH M AH N T 	dZ 2 dZ m 2 n t 
JUDGMENT 	JH AH JH M AH N T 	dZ 2 dZ m 2 n t 
JUG 	JH AH G 	dZ 2 g 
JUGGLING 	JH AH G AH L IH NG 	dZ 2 g 2 l I N 
JUGULAR 	JH UW G Y AH L ER 	dZ u g j 2 l E R 
JUICE 	JH UW S 	dZ u s 
JUMBO 	JH AH M B OW 	dZ 2 m b o U 
JUMP 	JH AH M P 	dZ 2 m p 
JUNK 	JH AH NG K 	dZ 2 N k 
JUNKIE 	JH AH NG K IY 	dZ 2 N k i 
JURISDICTION 	JH UH R AH S D IH K SH AH N 	dZ U r 2 s d I k S 2 n 
JURY 	JH UH R IY 	dZ U r i 
JUSTICE 	JH AH S T AH S 	dZ 2 s t 2 s 
JUSTIFICATION 	JH AH S T AH F AH K EY SH AH N 	dZ 2 s t 2 f 2 k e I S 2 n 
JUVENILE 	JH UW V AH N AH L 	dZ u v 2 n 2 l 
KALE 	K EY L 	k e I l 
KARMA 	K AA R M AH 	k a r m 2 
KEEP 	K IY P 	k i p 
KEEPING 	K IY P IH NG 	k i p I N 
KENNEL 	K EH N AH L 	k E n 2 l 
KEY 	K IY 	k i 
KEYSTONE 	K IY S T OW N 	k i s t o U n 
KEYWORD 	K IY W ER D 	k i w E R d 
KHAKI 	K AA K IY 	k a k i 
KICK 	K IH K 	k I k 
KID 	K IH D 	k I d 
KIDDIE 	K IH D IY 	k I d i 
KIDDING 	K IH D IH NG 	k I d I N 
KIDNAPPING 	K IH D N AE P IH NG 	k I d n ae p I N 
KIDNEY 	K IH D N IY 	k I d n i 
KILL 	K IH L 	k I l 
KILLER 	K IH L ER 	k I l E R 
KILLING 	K IH L IH NG 	k I l I N 
KILN 	K IH L N 	k I l n 
KILOMETER 	K AH L AA M AH T ER 	k 2 l a m 2 t E R 
KIND 	K AY N D 	k E I n d 
KINDERGARTEN 	K IH N D ER G AA R T AH N 	k I n d E R g a r t 2 n 
KINDNESS 	K AY N D N AH S 	k E I n d n 2 s 
KING 	K IH NG 	k I N 
KITCHEN 	K IH CH AH N 	k I tS 2 n 
KITTEN 	K IH T AH N 	k I t 2 n 
KITTY 	K IH T IY 	k I t i 
KNEE 	N IY 	n i 
KNIFE 	N AY F 	n E I f 
KNOCK 	N AA K 	n a k 
KNOW 	N OW 	n o U 
KNOWLEDGE 	N AA L AH JH 	n a l 2 dZ 
LAB 	L AE B 	l ae b 
LABEL 	L EY B AH L 	l e I b 2 l 
LABOR 	L EY B ER 	l e I b E R 
LABORER 	L EY B ER ER 	l e I b E R E R 
LABYRINTH 	L AE B ER IH N TH 	l ae b E R I n T 
LACK 	L AE K 	l ae k 
LADY 	L EY D IY 	l e I d i 
LAMB 	L AE M 	l ae m 
LAMP 	L AE M P 	l ae m p 
LAND 	L AE N D 	l ae n d 
LANDING 	L AE N D IH NG 	l ae n d I N 
LANDLORD 	L AE N D L AO R D 	l ae n d l O r d 
LANDMARK 	L AE N D M AA R K 	l ae n d m a r k 
LANDSCAPE 	L AE N D S K EY P 	l ae n d s k e I p 
LANE 	L EY N 	l e I n 
LANGUAGE 	L AE NG G W AH JH 	l ae N g w 2 dZ 
LAP 	L AE P 	l ae p 
LAPSE 	L AE P S 	l ae p s 
LAPTOP 	L AE P T AA P 	l ae p t a p 
LASCIVIOUSNESS 	L AH S IH V IY AH S N AH S 	l 2 s I v i 2 s n 2 s 
LASER 	L EY Z ER 	l e I z E R 
LATER 	L EY T ER 	l e I t E R 
LATITUDES 	L AE T AH T UW D Z 	l ae t 2 t u d z 
LAUGHTER 	L AE F T ER 	l ae f t E R 
LAUNCH 	L AO N CH 	l O n tS 
LAUNCHER 	L AO N CH ER 	l O n tS E R 
LAUNCHING 	L AO N CH IH NG 	l O n tS I N 
LAUNDRY 	L AO N D R IY 	l O n d r i 
LAUREL 	L AO R AH L 	l O r 2 l 
LAVA 	L AA V AH 	l a v 2 
LAW 	L AO 	l O 
LAWLESSNESS 	L AO L AH S N AH S 	l O l 2 s n 2 s 
LAWMAKER 	L AO M EY K ER 	l O m e I k E R 
LAWSUIT 	L AO S UW T 	l O s u t 
LAWYER 	L AO Y ER 	l O j E R 
LAYER 	L EY ER 	l e I E R 
LAYOUT 	L EY AW T 	l e I E U t 
LEAD 	L EH D 	l E d 
LEADER 	L IY D ER 	l i d E R 
LEADERSHIP 	L IY D ER SH IH P 	l i d E R S I p 
LEAF 	L IY F 	l i f 
LEAFLET 	L IY F L AH T 	l i f l 2 t 
LEAFY 	L IY F IY 	l i f i 
LEAK 	L IY K 	l i k 
LEAKAGE 	L IY K AH JH 	l i k 2 dZ 
LEAP 	L IY P 	l i p 
LEARNING 	L ER N IH NG 	l E R n I N 
LEASE 	L IY S 	l i s 
LEASH 	L IY SH 	l i S 
LEATHER 	L EH DH ER 	l E D E R 
LEAVE 	L IY V 	l i v 
LECTURE 	L EH K CH ER 	l E k tS E R 
LEDGER 	L EH JH ER 	l E dZ E R 
LEFT 	L EH F T 	l E f t 
LEG 	L EH G 	l E g 
LEGACY 	L EH G AH S IY 	l E g 2 s i 
LEGAL 	L IY G AH L 	l i g 2 l 
LEGEND 	L EH JH AH N D 	l E dZ 2 n d 
LEGISLATURE 	L EH JH AH S L EY CH ER 	l E dZ 2 s l e I tS E R 
LEGITIMACY 	L AH JH IH T AH M AH S IY 	l 2 dZ I t 2 m 2 s i 
LEISURE 	L EH ZH ER 	l E Z E R 
LEMONADE 	L EH M AH N EY D 	l E m 2 n e I d 
LENGTH 	L EH NG K TH 	l E N k T 
LENS 	L EH N Z 	l E n z 
LESION 	L IY ZH AH N 	l i Z 2 n 
LESSON 	L EH S AH N 	l E s 2 n 
LET 	L EH T 	l E t 
LETHARGY 	L EH TH ER JH IY 	l E T E R dZ i 
LETTER 	L EH T ER 	l E t E R 
LETTUCE 	L EH T AH S 	l E t 2 s 
LEVEL 	L EH V AH L 	l E v 2 l 
LEVERAGE 	L EH V ER IH JH 	l E v E R I dZ 
LIABILITY 	L AY AH B IH L IH T IY 	l E I 2 b I l I t i 
LIAR 	L AY ER 	l E I E R 
LIBEL 	L AY B EH L 	l E I b E l 
LIBERAL 	L IH B ER AH L 	l I b E R 2 l 
LIBERATION 	L IH B ER EY SH AH N 	l I b E R e I S 2 n 
LIBERTARIAN 	L IH B ER T EH R IY AH N 	l I b E R t E r i 2 n 
LIBERTY 	L IH B ER T IY 	l I b E R t i 
LICENSE 	L AY S AH N S 	l E I s 2 n s 
LIE 	L AY 	l E I 
LIEU 	L UW 	l u 
LIEUTENANT 	L UW T EH N AH N T 	l u t E n 2 n t 
LIFE 	L AY F 	l E I f 
LIFEBOAT 	L AY F B OW T 	l E I f b o U t 
LIFEGUARD 	L AY F G AA R D 	l E I f g a r d 
LIFESPAN 	L AY F S P AE N 	l E I f s p ae n 
LIFESTYLE 	L AY F S T AY L 	l E I f s t E I l 
LIFETIME 	L AY F T AY M 	l E I f t E I m 
LIFT 	L IH F T 	l I f t 
LIGHT 	L AY T 	l E I t 
LIGHTING 	L AY T IH NG 	l E I t I N 
LIKES 	L AY K S 	l E I k s 
LIMB 	L IH M 	l I m 
LIMBO 	L IH M B OW 	l I m b o U 
LIMIT 	L IH M AH T 	l I m 2 t 
LIMITATION 	L IH M IH T EY SH AH N 	l I m I t e I S 2 n 
LINE 	L AY N 	l E I n 
LINEN 	L IH N AH N 	l I n 2 n 
LINER 	L AY N ER 	l E I n E R 
LINGUIST 	L IH NG G W IH S T 	l I N g w I s t 
LINK 	L IH NG K 	l I N k 
LION 	L AY AH N 	l E I 2 n 
LIP 	L IH P 	l I p 
LIPID 	L AY P AH D 	l E I p 2 d 
LIQUIDATION 	L IH K W IH D EY SH AH N 	l I k w I d e I S 2 n 
LIQUOR 	L IH K ER 	l I k E R 
LISP 	L IH S P 	l I s p 
LIST 	L IH S T 	l I s t 
LISTENER 	L IH S AH N ER 	l I s 2 n E R 
LISTENING 	L IH S AH N IH NG 	l I s 2 n I N 
LISTING 	L IH S T IH NG 	l I s t I N 
LISTLESSNESS 	L IH S T L AH S N AH S 	l I s t l 2 s n 2 s 
LITERATURE 	L IH T ER AH CH ER 	l I t E R 2 tS E R 
LITHOGRAPH 	L IH TH AH G R AE F 	l I T 2 g r ae f 
LITIGATION 	L IH T AH G EY SH AH N 	l I t 2 g e I S 2 n 
LITTER 	L IH T ER 	l I t E R 
LITTLE 	L IH T AH L 	l I t 2 l 
LIVE 	L AY V 	l E I v 
LIVER 	L IH V ER 	l I v E R 
LIVESTOCK 	L AY V S T AA K 	l E I v s t a k 
LIVING 	L IH V IH NG 	l I v I N 
LIZARD 	L IH Z ER D 	l I z E R d 
LOAD 	L OW D 	l o U d 
LOADING 	L OW D IH NG 	l o U d I N 
LOAN 	L OW N 	l o U n 
LOBBY 	L AA B IY 	l a b i 
LOBBYIST 	L AA B IY AH S T 	l a b i 2 s t 
LOBSTER 	L AA B S T ER 	l a b s t E R 
LOCATION 	L OW K EY SH AH N 	l o U k e I S 2 n 
LOCK 	L AA K 	l a k 
LOCKER 	L AA K ER 	l a k E R 
LODGE 	L AA JH 	l a dZ 
LODGING 	L AA JH IH NG 	l a dZ I N 
LOGIC 	L AA JH IH K 	l a dZ I k 
LOGO 	L OW G OW 	l o U g o U 
LONG 	L AO NG 	l O N 
LONGEVITY 	L AO N JH EH V AH T IY 	l O n dZ E v 2 t i 
LONGSHOREMAN 	L AO NG SH OW R M AE N 	l O N S o U r m ae n 
LOOK 	L UH K 	l U k 
LOOKOUT 	L UH K AW T 	l U k E U t 
LOOP 	L UW P 	l u p 
LOOSER 	L UW S ER 	l u s E R 
LOOT 	L UW T 	l u t 
LOOTER 	L UW T ER 	l u t E R 
LOOTING 	L UW T IH NG 	l u t I N 
LOPE 	L OW P 	l o U p 
LOSER 	L UW Z ER 	l u z E R 
LOSS 	L AO S 	l O s 
LOT 	L AA T 	l a t 
LOTTERY 	L AA T ER IY 	l a t E R i 
LOTUS 	L OW T AH S 	l o U t 2 s 
LOUNGE 	L AW N JH 	l E U n dZ 
LOVE 	L AH V 	l 2 v 
LOVER 	L AH V ER 	l 2 v E R 
LOW 	L OW 	l o U 
LUBE 	L UW B 	l u b 
LUCK 	L AH K 	l 2 k 
LUNATIC 	L UW N AH T IH K 	l u n 2 t I k 
LUNCH 	L AH N CH 	l 2 n tS 
LUNCHEON 	L AH N CH AH N 	l 2 n tS 2 n 
LUNG 	L AH NG 	l 2 N 
LUXURY 	L AH G ZH ER IY 	l 2 g Z E R i 
LYMPHOMA 	L IH M F OW M AH 	l I m f o U m 2 
LYRIC 	L IH R IH K 	l I r I k 
MACHINE 	M AH SH IY N 	m 2 S i n 
MACROCOSM 	M AE K R AH K AH Z AH M 	m ae k r 2 k 2 z 2 m 
MADAM 	M AE D AH M 	m ae d 2 m 
MAGAZINE 	M AE G AH Z IY N 	m ae g 2 z i n 
MAGIC 	M AE JH IH K 	m ae dZ I k 
MAGICIAN 	M AH JH IH SH AH N 	m 2 dZ I S 2 n 
MAGNESIUM 	M AE G N IY Z IY AH M 	m ae g n i z i 2 m 
MAGNET 	M AE G N AH T 	m ae g n 2 t 
MAGNITUDE 	M AE G N AH T UW D 	m ae g n 2 t u d 
MAID 	M EY D 	m e I d 
MAIL 	M EY L 	m e I l 
MAILER 	M EY L ER 	m e I l E R 
MAILING 	M EY L IH NG 	m e I l I N 
MAINSTREAM 	M EY N S T R IY M 	m e I n s t r i m 
MAINTENANCE 	M EY N T AH N AH N S 	m e I n t 2 n 2 n s 
MAJORITY 	M AH JH AO R AH T IY 	m 2 dZ O r 2 t i 
MAKER 	M EY K ER 	m e I k E R 
MAKING 	M EY K IH NG 	m e I k I N 
MALE 	M EY L 	m e I l 
MALL 	M AO L 	m O l 
MAMA 	M AA M AH 	m a m 2 
MANAGEMENT 	M AE N AH JH M AH N T 	m ae n 2 dZ m 2 n t 
MANAGER 	M AE N AH JH ER 	m ae n 2 dZ E R 
MANGER 	M EY N JH ER 	m e I n dZ E R 
MANGO 	M AE NG G OW 	m ae N g o U 
MANHUNT 	M AE N HH AH N T 	m ae n h 2 n t 
MANIAC 	M EY N IY AE K 	m e I n i ae k 
MANICURE 	M AE N IH K Y ER 	m ae n I k j E R 
MANIFESTATION 	M AE N AH F EH S T EY SH AH N 	m ae n 2 f E s t e I S 2 n 
MANIFOLD 	M AE N AH F OW L D 	m ae n 2 f o U l d 
MANIKIN 	M AE N IH K AH N 	m ae n I k 2 n 
MANKIND 	M AE N K AY N D 	m ae n k E I n d 
MANLINESS 	M AE N L IY N AH S 	m ae n l i n 2 s 
MANNER 	M AE N ER 	m ae n E R 
MANNERS 	M AE N ER Z 	m ae n E R z 
MANTRA 	M AE N T R AH 	m ae n t r 2 
MANUAL 	M AE N Y UW AH L 	m ae n j u 2 l 
MANUFACTURE 	M AE N Y AH F AE K CH ER 	m ae n j 2 f ae k tS E R 
MANUFACTURER 	M AE N Y AH F AE K CH ER ER 	m ae n j 2 f ae k tS E R E R 
MANUFACTURING 	M AE N Y AH F AE K CH ER IH NG 	m ae n j 2 f ae k tS E R I N 
MANY 	M EH N IY 	m E n i 
MAP 	M AE P 	m ae p 
MAPLE 	M EY P AH L 	m e I p 2 l 
MAPPING 	M AE P IH NG 	m ae p I N 
MARCH 	M AA R CH 	m a r tS 
MARE 	M EH R 	m E r 
MARGARITA 	M AA R G ER IY T AH 	m a r g E R i t 2 
MARGIN 	M AA R JH AH N 	m a r dZ 2 n 
MARIONETTE 	M AE R IY AH N EH T 	m ae r i 2 n E t 
MARK 	M AA R K 	m a r k 
MARKET 	M AA R K AH T 	m a r k 2 t 
MARKETER 	M AA R K AH T ER 	m a r k 2 t E R 
MARKETING 	M AA R K AH T IH NG 	m a r k 2 t I N 
MARKETPLACE 	M AA R K AH T P L EY S 	m a r k 2 t p l e I s 
MARKING 	M AA R K IH NG 	m a r k I N 
MARRIAGE 	M EH R IH JH 	m E r I dZ 
MARRYING 	M EH R IY IH NG 	m E r i I N 
MARTYR 	M AA R T ER 	m a r t E R 
MASK 	M AE S K 	m ae s k 
MASQUERADE 	M AE S K ER EY D 	m ae s k E R e I d 
MASS 	M AE S 	m ae s 
MASSACRE 	M AE S AH K ER 	m ae s 2 k E R 
MASSAGE 	M AH S AA ZH 	m 2 s a Z 
MASTER 	M AE S T ER 	m ae s t E R 
MASTERMIND 	M AE S T ER M AY N D 	m ae s t E R m E I n d 
MATCH 	M AE CH 	m ae tS 
MATCHING 	M AE CH IH NG 	m ae tS I N 
MATE 	M EY T 	m e I t 
MATERIAL 	M AH T IH R IY AH L 	m 2 t I r i 2 l 
MATH 	M AE TH 	m ae T 
MATRIX 	M EY T R IH K S 	m e I t r I k s 
MATTER 	M AE T ER 	m ae t E R 
MAW 	M AO 	m O 
MAXIMUM 	M AE K S AH M AH M 	m ae k s 2 m 2 m 
MAYONNAISE 	M EY AH N EY Z 	m e I 2 n e I z 
MAYOR 	M EY ER 	m e I E R 
MEADOWLARK 	M EH D OW L AA R K 	m E d o U l a r k 
MEAL 	M IY L 	m i l 
MEAN 	M IY N 	m i n 
MEANING 	M IY N IH NG 	m i n I N 
MEANS 	M IY N Z 	m i n z 
MEANTIME 	M IY N T AY M 	m i n t E I m 
MEANWHILE 	M IY N W AY L 	m i n w E I l 
MEASURE 	M EH ZH ER 	m E Z E R 
MEAT 	M IY T 	m i t 
MEATBALL 	M IY T B AO L 	m i t b O l 
MECHANIC 	M AH K AE N IH K 	m 2 k ae n I k 
MECHANICS 	M AH K AE N IH K S 	m 2 k ae n I k s 
MECHANISM 	M EH K AH N IH Z AH M 	m E k 2 n I z 2 m 
MEDAL 	M EH D AH L 	m E d 2 l 
MEDIA 	M IY D IY AH 	m i d i 2 
MEDIATION 	M IY D IY EY SH AH N 	m i d i e I S 2 n 
MEDICATION 	M EH D AH K EY SH AH N 	m E d 2 k e I S 2 n 
MEDICINE 	M EH D AH S AH N 	m E d 2 s 2 n 
MEDITATION 	M EH D AH T EY SH AH N 	m E d 2 t e I S 2 n 
MEDIUM 	M IY D IY AH M 	m i d i 2 m 
MEETING 	M IY T IH NG 	m i t I N 
MEGAPIXEL 	M EH G AH P IH K S AH L 	m E g 2 p I k s 2 l 
MELTING 	M EH L T IH NG 	m E l t I N 
MEMBER 	M EH M B ER 	m E m b E R 
MEMBERSHIP 	M EH M B ER SH IH P 	m E m b E R S I p 
MEMBRANE 	M EH M B R EY N 	m E m b r e I n 
MEMO 	M EH M OW 	m E m o U 
MEMOIR 	M EH M W AA R 	m E m w a r 
MEMORY 	M EH M ER IY 	m E m E R i 
MENACE 	M EH N AH S 	m E n 2 s 
MENSTRUATION 	M EH N S T R UW EY SH AH N 	m E n s t r u e I S 2 n 
MENU 	M EH N Y UW 	m E n j u 
MEOWING 	M IY OW AH NG 	m i o U 2 N 
MERCENARY 	M ER S AH N EH R IY 	m E R s 2 n E r i 
MERCHANT 	M ER CH AH N T 	m E R tS 2 n t 
MERCURY 	M ER K Y ER IY 	m E R k j E R i 
MERCY 	M ER S IY 	m E R s i 
MERGER 	M ER JH ER 	m E R dZ E R 
MERIT 	M EH R AH T 	m E r 2 t 
MESH 	M EH SH 	m E S 
MESS 	M EH S 	m E s 
MESSAGE 	M EH S AH JH 	m E s 2 dZ 
METABOLISM 	M AH T AE B AH L IH Z AH M 	m 2 t ae b 2 l I z 2 m 
METAL 	M EH T AH L 	m E t 2 l 
METAPHOR 	M EH T AH F AO R 	m E t 2 f O r 
METASTASIS 	M AH T AE S T AH S IH S 	m 2 t ae s t 2 s I s 
METER 	M IY T ER 	m i t E R 
METERING 	M IY T ER IH NG 	m i t E R I N 
METHOD 	M EH TH AH D 	m E T 2 d 
METHODOLOGY 	M EH TH AH D AA L AH JH IY 	m E T 2 d a l 2 dZ i 
METRO 	M EH T R OW 	m E t r o U 
MICROBIOLOGIST 	M AY K R OW B IY AA L AH JH IH S T 	m E I k r o U b i a l 2 dZ I s t 
MICROCOMPUTER 	M AY K R OW K AH M P Y UW T ER 	m E I k r o U k 2 m p j u t E R 
MICROCOSM 	M AY K R AH K AA Z AH M 	m E I k r 2 k a z 2 m 
MICRON 	M AY K R AA N 	m E I k r a n 
MICROPHONE 	M AY K R AH F OW N 	m E I k r 2 f o U n 
MICROWAVE 	M AY K R AH W EY V 	m E I k r 2 w e I v 
MIDDLE 	M IH D AH L 	m I d 2 l 
MIDGET 	M IH JH AH T 	m I dZ 2 t 
MIDST 	M IH D S T 	m I d s t 
MIDTERM 	M IH D T ER M 	m I d t E R m 
MIGRANT 	M AY G R AH N T 	m E I g r 2 n t 
MIGRATION 	M AY G R EY SH AH N 	m E I g r e I S 2 n 
MILDEW 	M IH L D UW 	m I l d u 
MILE 	M AY L 	m E I l 
MILEAGE 	M AY L AH JH 	m E I l 2 dZ 
MILIEU 	M IH L Y UH 	m I l j U 
MILITANT 	M IH L AH T AH N T 	m I l 2 t 2 n t 
MILITARISM 	M IH L AH T ER IH Z AH M 	m I l 2 t E R I z 2 m 
MILITARY 	M IH L AH T EH R IY 	m I l 2 t E r i 
MILITIA 	M AH L IH SH AH 	m 2 l I S 2 
MILK 	M IH L K 	m I l k 
MILL 	M IH L 	m I l 
MILLENNIUM 	M AH L EH N IY AH M 	m 2 l E n i 2 m 
MILLET 	M IH L AH T 	m I l 2 t 
MILLING 	M IH L IH NG 	m I l I N 
MILLION 	M IH L Y AH N 	m I l j 2 n 
MIMOSA 	M IH M OW S AH 	m I m o U s 2 
MIND 	M AY N D 	m E I n d 
MINE 	M AY N 	m E I n 
MINERAL 	M IH N ER AH L 	m I n E R 2 l 
MINIATURE 	M IH N IY AH CH UH R 	m I n i 2 tS U r 
MINIMUM 	M IH N AH M AH M 	m I n 2 m 2 m 
MINING 	M AY N IH NG 	m E I n I N 
MINISTER 	M IH N AH S T ER 	m I n 2 s t E R 
MINORITY 	M AY N AO R AH T IY 	m E I n O r 2 t i 
MINUTE 	M IH N AH T 	m I n 2 t 
MIRACLE 	M IH R AH K AH L 	m I r 2 k 2 l 
MIRTH 	M ER TH 	m E R T 
MISANTHROPY 	M IH S AH N TH R OW P IY 	m I s 2 n T r o U p i 
MISCHIEF 	M IH S CH AH F 	m I s tS 2 f 
MISCONCEPTION 	M IH S K AH N S EH P SH AH N 	m I s k 2 n s E p S 2 n 
MISCREANT 	M IH S K R IY AH N T 	m I s k r i 2 n t 
MISDIRECTION 	M IH S D AH R EH K SH AH N 	m I s d 2 r E k S 2 n 
MISERY 	M IH Z ER IY 	m I z E R i 
MISFORTUNE 	M IH S F AO R CH AH N 	m I s f O r tS 2 n 
MISINFORMATION 	M IH S IH N F ER M EY SH AH N 	m I s I n f E R m e I S 2 n 
MISOGYNY 	M IH Z AH JH IH N IY 	m I z 2 dZ I n i 
MISSILE 	M IH S AH L 	m I s 2 l 
MISSION 	M IH SH AH N 	m I S 2 n 
MISSIVE 	M IH S IH V 	m I s I v 
MISSTATEMENT 	M IH S T EY T M AH N T 	m I s t e I t m 2 n t 
MIST 	M IH S T 	m I s t 
MISTAKE 	M IH S T EY K 	m I s t e I k 
MISTREATMENT 	M IH S T R IY T M AH N T 	m I s t r i t m 2 n t 
MISUNDERSTANDING 	M IH S AH N D ER S T AE N D IH NG 	m I s 2 n d E R s t ae n d I N 
MITIGATING 	M IH T AH G EY T IH NG 	m I t 2 g e I t I N 
MIX 	M IH K S 	m I k s 
MIXING 	M IH K S IH NG 	m I k s I N 
MIXTURE 	M IH K S CH ER 	m I k s tS E R 
MOD 	M AO D 	m O d 
MODE 	M OW D 	m o U d 
MODEL 	M AA D AH L 	m a d 2 l 
MODELING 	M AA D AH L IH NG 	m a d 2 l I N 
MODEM 	M OW D AH M 	m o U d 2 m 
MODERATE 	M AA D ER AH T 	m a d E R 2 t 
MODERATOR 	M AA D ER EY T ER 	m a d E R e I t E R 
MODERNIZATION 	M AA D ER N AH Z EY SH AH N 	m a d E R n 2 z e I S 2 n 
MODICUM 	M AA D IH K AH M 	m a d I k 2 m 
MODULE 	M AA JH UW L 	m a dZ u l 
MOISTURE 	M OY S CH ER 	m U I s tS E R 
MOLD 	M OW L D 	m o U l d 
MOLDING 	M OW L D IH NG 	m o U l d I N 
MOLE 	M OW L 	m o U l 
MOLESTER 	M AH L EH S T ER 	m 2 l E s t E R 
MOM 	M AA M 	m a m 
MOMENT 	M OW M AH N T 	m o U m 2 n t 
MOMMY 	M AA M IY 	m a m i 
MONARCHY 	M AA N AA R K IY 	m a n a r k i 
MONEY 	M AH N IY 	m 2 n i 
MONKEY 	M AH NG K IY 	m 2 N k i 
MONOPOLY 	M AH N AA P AH L IY 	m 2 n a p 2 l i 
MONOTONY 	M AH N AA T AH N IY 	m 2 n a t 2 n i 
MONTH 	M AH N TH 	m 2 n T 
MOO 	M UW 	m u 
MOON 	M UW N 	m u n 
MOOR 	M UH R 	m U r 
MOORLAND 	M UH R L AE N D 	m U r l ae n d 
MOP 	M AA P 	m a p 
MORALE 	M ER AE L 	m E R ae l 
MORALITY 	M AO R AE L AH T IY 	m O r ae l 2 t i 
MORBIDITY 	M AO R B IH D AH T IY 	m O r b I d 2 t i 
MORNING 	M AO R N IH NG 	m O r n I N 
MORTAR 	M AO R T ER 	m O r t E R 
MOSQUE 	M AA S K 	m a s k 
MOSQUITO 	M AH S K IY T OW 	m 2 s k i t o U 
MOTEL 	M OW T EH L 	m o U t E l 
MOTHER 	M AH DH ER 	m 2 D E R 
MOTION 	M OW SH AH N 	m o U S 2 n 
MOTIVATION 	M OW T AH V EY SH AH N 	m o U t 2 v e I S 2 n 
MOTIVE 	M OW T IH V 	m o U t I v 
MOTOR 	M OW T ER 	m o U t E R 
MOTORCYCLE 	M OW T ER S AY K AH L 	m o U t E R s E I k 2 l 
MOTTO 	M AA T OW 	m a t o U 
MOUND 	M AW N D 	m E U n d 
MOUNTAIN 	M AW N T AH N 	m E U n t 2 n 
MOUNTAINTOP 	M AW N T AH N T AA P 	m E U n t 2 n t a p 
MOUNTING 	M AW N T IH NG 	m E U n t I N 
MOUSSE 	M UW S 	m u s 
MOUTH 	M AW TH 	m E U T 
MOUTHPIECE 	M AW TH P IY S 	m E U T p i s 
MOVE 	M UW V 	m u v 
MOVEMENT 	M UW V M AH N T 	m u v m 2 n t 
MOVIE 	M UW V IY 	m u v i 
MOVING 	M UW V IH NG 	m u v I N 
MUCH 	M AH CH 	m 2 tS 
MUD 	M AH D 	m 2 d 
MUFF 	M AH F 	m 2 f 
MULLAH 	M AH L AH 	m 2 l 2 
MULTIPLEX 	M AH L T IY P L EH K S 	m 2 l t i p l E k s 
MULTITUDE 	M AH L T AH T UW D 	m 2 l t 2 t u d 
MUNICIPALITY 	M Y UW N IH S AH P AE L AH T IY 	m j u n I s 2 p ae l 2 t i 
MURDER 	M ER D ER 	m E R d E R 
MURDERER 	M ER D ER ER 	m E R d E R E R 
MURDERING 	M ER D ER IH NG 	m E R d E R I N 
MUSCLE 	M AH S AH L 	m 2 s 2 l 
MUSEUM 	M Y UW Z IY AH M 	m j u z i 2 m 
MUSH 	M AH SH 	m 2 S 
MUSIC 	M Y UW Z IH K 	m j u z I k 
MUSICAL 	M Y UW Z IH K AH L 	m j u z I k 2 l 
MUSICIAN 	M Y UW Z IH SH AH N 	m j u z I S 2 n 
MUSK 	M AH S K 	m 2 s k 
MUSSEL 	M AH S AH L 	m 2 s 2 l 
MUSTER 	M AH S T ER 	m 2 s t E R 
MUTILATION 	M Y UW T AH L EY SH AH N 	m j u t 2 l e I S 2 n 
MUTT 	M AH T 	m 2 t 
MYSTERY 	M IH S T ER IY 	m I s t E R i 
MYSTICISM 	M IH S T IH S IH Z AH M 	m I s t I s I z 2 m 
MYTH 	M IH TH 	m I T 
NACHO 	N AE CH OW 	n ae tS o U 
NAIL 	N EY L 	n e I l 
NAIVETY 	N AA IY V AH T EY IY 	n a i v 2 t e I i 
NAME 	N EY M 	n e I m 
NAMING 	N EY M IH NG 	n e I m I N 
NAPKIN 	N AE P K IH N 	n ae p k I n 
NATION 	N EY SH AH N 	n e I S 2 n 
NATIONAL 	N AE SH AH N AH L 	n ae S 2 n 2 l 
NATIONALISM 	N AE SH AH N AH L IH Z AH M 	n ae S 2 n 2 l I z 2 m 
NATIONALIST 	N AE SH AH N AH L AH S T 	n ae S 2 n 2 l 2 s t 
NATIONALITY 	N AE SH AH N AE L AH T IY 	n ae S 2 n ae l 2 t i 
NATIVE 	N EY T IH V 	n e I t I v 
NATURE 	N EY CH ER 	n e I tS E R 
NAUSEA 	N AO Z IY AH 	n O z i 2 
NAVIGATION 	N AE V AH G EY SH AH N 	n ae v 2 g e I S 2 n 
NAVY 	N EY V IY 	n e I v i 
NECESSITY 	N AH S EH S AH T IY 	n 2 s E s 2 t i 
NECK 	N EH K 	n E k 
NEED 	N IY D 	n i d 
NEEDLE 	N IY D AH L 	n i d 2 l 
NEGATIVE 	N EH G AH T IH V 	n E g 2 t I v 
NEGLIGENCE 	N EH G L AH JH AH N S 	n E g l 2 dZ 2 n s 
NEGOTIATING 	N IH G OW SH IY EY T IH NG 	n I g o U S i e I t I N 
NEGOTIATION 	N IH G OW SH IY EY SH AH N 	n I g o U S i e I S 2 n 
NEGOTIATOR 	N AH G OW SH IY EY T ER 	n 2 g o U S i e I t E R 
NEIGHBOR 	N EY B ER 	n e I b E R 
NEIGHBORHOOD 	N EY B ER HH UH D 	n e I b E R h U d 
NEON 	N IY AA N 	n i a n 
NEPHEW 	N EH F Y UW 	n E f j u 
NERD 	N ER D 	n E R d 
NERVE 	N ER V 	n E R v 
NEST 	N EH S T 	n E s t 
NET 	N EH T 	n E t 
NETTING 	N EH T IH NG 	n E t I N 
NETWORK 	N EH T W ER K 	n E t w E R k 
NETWORKING 	N EH T W ER K IH NG 	n E t w E R k I N 
NEUROLOGY 	N UH R AA L AH JH IY 	n U r a l 2 dZ i 
NEUTER 	N UW T ER 	n u t E R 
NEW 	N UW 	n u 
NEWBORN 	N UW B AO R N 	n u b O r n 
NEWS 	N UW Z 	n u z 
NEWSLETTER 	N UW Z L EH T ER 	n u z l E t E R 
NEWSPAPER 	N UW Z P EY P ER 	n u z p e I p E R 
NICE 	N AY S 	n E I s 
NICHE 	N IH SH 	n I S 
NICK 	N IH K 	n I k 
NICKNAME 	N IH K N EY M 	n I k n e I m 
NIGHT 	N AY T 	n E I t 
NIGHTLIFE 	N AY T L AY F 	n E I t l E I f 
NIGHTMARE 	N AY T M EH R 	n E I t m E r 
NITROGEN 	N AY T R AH JH AH N 	n E I t r 2 dZ 2 n 
NODE 	N OW D 	n o U d 
NOISE 	N OY Z 	n U I z 
NOMENCLATURE 	N OW M AH N K L EY CH ER 	n o U m 2 n k l e I tS E R 
NOMINATION 	N AA M AH N EY SH AH N 	n a m 2 n e I S 2 n 
NONE 	N AH N 	n 2 n 
NOON 	N UW N 	n u n 
NORM 	N AO R M 	n O r m 
NORMAL 	N AO R M AH L 	n O r m 2 l 
NORMALITY 	N AO R M AE L AH T IY 	n O r m ae l 2 t i 
NORTH 	N AO R TH 	n O r T 
NORTHEAST 	N AO R TH IY S T 	n O r T i s t 
NORTHWEST 	N AO R TH W EH S T 	n O r T w E s t 
NOSE 	N OW Z 	n o U z 
NOSTRIL 	N AA S T R IH L 	n a s t r I l 
NOTCH 	N AA CH 	n a tS 
NOTE 	N OW T 	n o U t 
NOTEBOOK 	N OW T B UH K 	n o U t b U k 
NOTEPAD 	N OW T P AE D 	n o U t p ae d 
NOTICE 	N OW T AH S 	n o U t 2 s 
NOTIFICATION 	N OW T AH F AH K EY SH AH N 	n o U t 2 f 2 k e I S 2 n 
NOTION 	N OW SH AH N 	n o U S 2 n 
NOVEL 	N AA V AH L 	n a v 2 l 
NUDE 	N UW D 	n u d 
NUDGING 	N AH JH IH NG 	n 2 dZ I N 
NUKE 	N UW K 	n u k 
NUMBER 	N AH M B ER 	n 2 m b E R 
NUN 	N AH N 	n 2 n 
NURSE 	N ER S 	n E R s 
NUTRIENT 	N UW T R IY AH N T 	n u t r i 2 n t 
OAK 	OW K 	o U k 
OATMEAL 	OW T M IY L 	o U t m i l 
OBEDIENCE 	OW B IY D IY AH N S 	o U b i d i 2 n s 
OBESITY 	OW B IY S AH T IY 	o U b i s 2 t i 
OBJECT 	AA B JH EH K T 	a b dZ E k t 
OBJECTION 	AH B JH EH K SH AH N 	2 b dZ E k S 2 n 
OBJECTIVE 	AH B JH EH K T IH V 	2 b dZ E k t I v 
OBLIGATION 	AA B L AH G EY SH AH N 	a b l 2 g e I S 2 n 
OBSCURITY 	AH B S K Y UH R AH T IY 	2 b s k j U r 2 t i 
OBSERVATION 	AA B Z ER V EY SH AH N 	a b z E R v e I S 2 n 
OBSERVER 	AH B Z ER V ER 	2 b z E R v E R 
OBSTACLE 	AA B S T AH K AH L 	a b s t 2 k 2 l 
OBSTRUCTION 	AH B S T R AH K SH AH N 	2 b s t r 2 k S 2 n 
OCCASION 	AH K EY ZH AH N 	2 k e I Z 2 n 
OCCUPANCY 	AA K Y AH P AH N S IY 	a k j 2 p 2 n s i 
OCCUPATION 	AA K Y AH P EY SH AH N 	a k j 2 p e I S 2 n 
OCCURRENCE 	AH K ER AH N S 	2 k E R 2 n s 
OCEAN 	OW SH AH N 	o U S 2 n 
O'CLOCK 	AH K L AA K 	2 k l a k 
OFF 	AO F 	O f 
OFFENSIVE 	AH F EH N S IH V 	2 f E n s I v 
OFFER 	AO F ER 	O f E R 
OFFERING 	AO F ER IH NG 	O f E R I N 
OFFICE 	AO F AH S 	O f 2 s 
OFFICER 	AO F AH S ER 	O f 2 s E R 
OFFICIAL 	AH F IH SH AH L 	2 f I S 2 l 
OFFSPRING 	AO F S P R IH NG 	O f s p r I N 
OIL 	OY L 	U I l 
OILFIELD 	OY L F IY L D 	U I l f i l d 
OLD 	OW L D 	o U l d 
OMELET 	AA M L AH T 	a m l 2 t 
OMISSION 	OW M IH SH AH N 	o U m I S 2 n 
OMNIBUS 	AA M N AH B AH S 	a m n 2 b 2 s 
ONCE 	W AH N S 	w 2 n s 
ONE 	W AH N 	w 2 n 
ONION 	AH N Y AH N 	2 n j 2 n 
ONLINE 	AO N L AY N 	O n l E I n 
OPEN 	OW P AH N 	o U p 2 n 
OPENER 	OW P AH N ER 	o U p 2 n E R 
OPENING 	OW P AH N IH NG 	o U p 2 n I N 
OPERA 	AA P R AH 	a p r 2 
OPERATING 	AA P ER EY T IH NG 	a p E R e I t I N 
OPERATION 	AA P ER EY SH AH N 	a p E R e I S 2 n 
OPERATIVE 	AA P ER AH T IH V 	a p E R 2 t I v 
OPERATOR 	AA P ER EY T ER 	a p E R e I t E R 
OPINION 	AH P IH N Y AH N 	2 p I n j 2 n 
OPOSSUM 	OW P AA S AH M 	o U p a s 2 m 
OPPORTUNITY 	AA P ER T UW N AH T IY 	a p E R t u n 2 t i 
OPPOSITE 	AA P AH Z IH T 	a p 2 z I t 
OPPOSITION 	AA P AH Z IH SH AH N 	a p 2 z I S 2 n 
OPTIMIZATION 	AA P T AH M AH Z EY SH AH N 	a p t 2 m 2 z e I S 2 n 
OPTION 	AA P SH AH N 	a p S 2 n 
ORANGE 	AO R AH N JH 	O r 2 n dZ 
ORBIT 	AO R B AH T 	O r b 2 t 
ORCHESTRA 	AO R K AH S T R AH 	O r k 2 s t r 2 
ORDEAL 	AO R D IY L 	O r d i l 
ORDER 	AO R D ER 	O r d E R 
ORDERING 	AO R D ER IH NG 	O r d E R I N 
OREGANO 	AO R EH G AH N OW 	O r E g 2 n o U 
ORGAN 	AO R G AH N 	O r g 2 n 
ORGANISM 	AO R G AH N IH Z AH M 	O r g 2 n I z 2 m 
ORGANIZATION 	AO R G AH N AH Z EY SH AH N 	O r g 2 n 2 z e I S 2 n 
ORGANIZING 	AO R G AH N AY Z IH NG 	O r g 2 n E I z I N 
ORIENTATION 	AO R IY EH N T EY SH AH N 	O r i E n t e I S 2 n 
ORIGAMI 	AO R IY G AA M IY 	O r i g a m i 
ORIGIN 	AO R AH JH AH N 	O r 2 dZ 2 n 
ORIGINAL 	ER IH JH AH N AH L 	E R I dZ 2 n 2 l 
ORIGINATION 	ER IH JH AH N EY SH AH N 	E R I dZ 2 n e I S 2 n 
ORNAMENT 	AO R N AH M AH N T 	O r n 2 m 2 n t 
ORPHAN 	AO R F AH N 	O r f 2 n 
ORTHODONTIST 	AO R TH AH D AA N T AH S T 	O r T 2 d a n t 2 s t 
OSTRICH 	AO S T R IH CH 	O s t r I tS 
OTHER 	AH DH ER 	2 D E R 
OUNCE 	AW N S 	E U n s 
OUSTER 	AW S T ER 	E U s t E R 
OUSTING 	AW S T IH NG 	E U s t I N 
OUT 	AW T 	E U t 
OUTAGE 	AW T AH JH 	E U t 2 dZ 
OUTBREAK 	AW T B R EY K 	E U t b r e I k 
OUTCOME 	AW T K AH M 	E U t k 2 m 
OUTFIT 	AW T F IH T 	E U t f I t 
OUTGROWTH 	AW T G R OW TH 	E U t g r o U T 
OUTING 	AW T IH NG 	E U t I N 
OUTLET 	AW T L EH T 	E U t l E t 
OUTLINE 	AW T L AY N 	E U t l E I n 
OUTPUT 	AW T P UH T 	E U t p U t 
OUTRAGE 	AW T R EY JH 	E U t r e I dZ 
OUTREACH 	AW T R IY CH 	E U t r i tS 
OUTSIDER 	AW T S AY D ER 	E U t s E I d E R 
OVEN 	AH V AH N 	2 v 2 n 
OVER 	OW V ER 	o U v E R 
OVERAGE 	OW V ER EY JH 	o U v E R e I dZ 
OVERCHARGE 	OW V ER CH AA R JH 	o U v E R tS a r dZ 
OVERDOSE 	OW V ER D OW S 	o U v E R d o U s 
OVERFLOW 	OW V ER F L OW 	o U v E R f l o U 
OVERNIGHT 	OW V ER N AY T 	o U v E R n E I t 
OVERSTATEMENT 	OW V ER S T EY T M AH N T 	o U v E R s t e I t m 2 n t 
OVERTHROW 	OW V ER TH R OW 	o U v E R T r o U 
OVERTURE 	OW V ER CH ER 	o U v E R tS E R 
OVERVIEW 	OW V ER V Y UW 	o U v E R v j u 
OWNER 	OW N ER 	o U n E R 
OWNERSHIP 	OW N ER SH IH P 	o U n E R S I p 
OXYGEN 	AA K S AH JH AH N 	a k s 2 dZ 2 n 
PACE 	P EY S 	p e I s 
PACK 	P AE K 	p ae k 
PACKAGE 	P AE K AH JH 	p ae k 2 dZ 
PACKER 	P AE K ER 	p ae k E R 
PACKET 	P AE K AH T 	p ae k 2 t 
PACT 	P AE K T 	p ae k t 
PAD 	P AE D 	p ae d 
PAGE 	P EY JH 	p e I dZ 
PAGER 	P EY JH ER 	p e I dZ E R 
PAIN 	P EY N 	p e I n 
PAINT 	P EY N T 	p e I n t 
PAINTER 	P EY N T ER 	p e I n t E R 
PAINTING 	P EY N T IH NG 	p e I n t I N 
PAIR 	P EH R 	p E r 
PAL 	P AE L 	p ae l 
PALACE 	P AE L AH S 	p ae l 2 s 
PALETTE 	P AE L AH T 	p ae l 2 t 
PALM 	P AA M 	p a m 
PAN 	P AE N 	p ae n 
PANCAKE 	P AE N K EY K 	p ae n k e I k 
PANE 	P EY N 	p e I n 
PANEL 	P AE N AH L 	p ae n 2 l 
PANIC 	P AE N IH K 	p ae n I k 
PANTS 	P AE N T S 	p ae n t s 
PAPER 	P EY P ER 	p e I p E R 
PAPERS 	P EY P ER Z 	p e I p E R z 
PAPERWORK 	P EY P ER W ER K 	p e I p E R w E R k 
PAR 	P AA R 	p a r 
PARACHUTE 	P EH R AH SH UW T 	p E r 2 S u t 
PARADE 	P ER EY D 	p E R e I d 
PARADED 	P ER EY D IH D 	p E R e I d I d 
PARADIGM 	P EH R AH D AY M 	p E r 2 d E I m 
PARADISE 	P EH R AH D AY S 	p E r 2 d E I s 
PARAGRAPH 	P AE R AH G R AE F 	p ae r 2 g r ae f 
PARAKEET 	P EH R AH K IY T 	p E r 2 k i t 
PARALEGAL 	P EH R AH L IY G AH L 	p E r 2 l i g 2 l 
PARAMETER 	P ER AE M AH T ER 	p E R ae m 2 t E R 
PARAMILITARY 	P EH R AH M IH L AH T EH R IY 	p E r 2 m I l 2 t E r i 
PARAPHERNALIA 	P EH R AH F AH N EY L Y AH 	p E r 2 f 2 n e I l j 2 
PARENT 	P EH R AH N T 	p E r 2 n t 
PARENTHESES 	P ER EH N TH AH S IY Z 	p E R E n T 2 s i z 
PARIAH 	P ER AY AH 	p E R E I 2 
PARISHIONER 	P ER IH SH AH N ER 	p E R I S 2 n E R 
PARK 	P AA R K 	p a r k 
PARKING 	P AA R K IH NG 	p a r k I N 
PARLIAMENT 	P AA R L AH M EH N T 	p a r l 2 m E n t 
PARODY 	P EH R AH D IY 	p E r 2 d i 
PAROLE 	P ER OW L 	p E R o U l 
PARROT 	P EH R AH T 	p E r 2 t 
PART 	P AA R T 	p a r t 
PARTICIPANT 	P AA R T IH S AH P AH N T 	p a r t I s 2 p 2 n t 
PARTICIPATION 	P AA R T IH S AH P EY SH AH N 	p a r t I s 2 p e I S 2 n 
PARTITION 	P AA R T IH SH AH N 	p a r t I S 2 n 
PARTNER 	P AA R T N ER 	p a r t n E R 
PARTNERSHIP 	P AA R T N ER SH IH P 	p a r t n E R S I p 
PARTY 	P AA R T IY 	p a r t i 
PASS 	P AE S 	p ae s 
PASSENGER 	P AE S AH N JH ER 	p ae s 2 n dZ E R 
PASSING 	P AE S IH NG 	p ae s I N 
PASSION 	P AE SH AH N 	p ae S 2 n 
PASSPORT 	P AE S P AO R T 	p ae s p O r t 
PASSWORD 	P AE S W ER D 	p ae s w E R d 
PAST 	P AE S T 	p ae s t 
PASTA 	P AA S T AH 	p a s t 2 
PASTE 	P EY S T 	p e I s t 
PASTOR 	P AE S T ER 	p ae s t E R 
PASTRY 	P EY S T R IY 	p e I s t r i 
PASTURE 	P AE S CH ER 	p ae s tS E R 
PAT 	P AE T 	p ae t 
PATENT 	P AE T AH N T 	p ae t 2 n t 
PATH 	P AE TH 	p ae T 
PATHOGEN 	P AE TH AH JH AH N 	p ae T 2 dZ 2 n 
PATIENCE 	P EY SH AH N S 	p e I S 2 n s 
PATIENT 	P EY SH AH N T 	p e I S 2 n t 
PATIENTS 	P EY SH AH N T S 	p e I S 2 n t s 
PATIO 	P AE T IY OW 	p ae t i o U 
PATROL 	P AH T R OW L 	p 2 t r o U l 
PATRON 	P EY T R AH N 	p e I t r 2 n 
PATRONAGE 	P AE T R AH N IH JH 	p ae t r 2 n I dZ 
PATTERN 	P AE T ER N 	p ae t E R n 
PATTY 	P AE T IY 	p ae t i 
PAW 	P AO 	p O 
PAYER 	P EY ER 	p e I E R 
PAYMENT 	P EY M AH N T 	p e I m 2 n t 
PAYOFF 	P EY AO F 	p e I O f 
PEA 	P IY 	p i 
PEACE 	P IY S 	p i s 
PEACEKEEPING 	P IY S K IY P IH NG 	p i s k i p I N 
PEAK 	P IY K 	p i k 
PEANUT 	P IY N AH T 	p i n 2 t 
PEASANT 	P EH Z AH N T 	p E z 2 n t 
PEDANTRY 	P EH D AH N T R IY 	p E d 2 n t r i 
PEDDLE 	P EH D AH L 	p E d 2 l 
PEDESTAL 	P EH D AH S T AH L 	p E d 2 s t 2 l 
PEDICURE 	P EH D IH K Y ER 	p E d I k j E R 
PEEL 	P IY L 	p i l 
PEER 	P IH R 	p I r 
PEN 	P EH N 	p E n 
PENALTY 	P EH N AH L T IY 	p E n 2 l t i 
PENCIL 	P EH N S AH L 	p E n s 2 l 
PENDING 	P EH N D IH NG 	p E n d I N 
PENDULUM 	P EH N JH AH L AH M 	p E n dZ 2 l 2 m 
PENINSULA 	P AH N IH N S AH L AH 	p 2 n I n s 2 l 2 
PENNY 	P EH N IY 	p E n i 
PEOPLE 	P IY P AH L 	p i p 2 l 
PEP 	P EH P 	p E p 
PEPPER 	P EH P ER 	p E p E R 
PEPPERONI 	P EH P ER OW N IY 	p E p E R o U n i 
PER 	P ER 	p E R 
PERCENT 	P ER S EH N T 	p E R s E n t 
PERCENTAGE 	P ER S EH N T AH JH 	p E R s E n t 2 dZ 
PERCEPTION 	P ER S EH P SH AH N 	p E R s E p S 2 n 
PERFECTION 	P ER F EH K SH AH N 	p E R f E k S 2 n 
PERFECTIONIST 	P ER F EH K SH AH N AH S T 	p E R f E k S 2 n 2 s t 
PERFORMANCE 	P ER F AO R M AH N S 	p E R f O r m 2 n s 
PERFORMER 	P ER F AO R M ER 	p E R f O r m E R 
PERFUME 	P ER F Y UW M 	p E R f j u m 
PERIL 	P EH R AH L 	p E r 2 l 
PERIOD 	P IH R IY AH D 	p I r i 2 d 
PERMISSION 	P ER M IH SH AH N 	p E R m I S 2 n 
PERMIT 	P ER M IH T 	p E R m I t 
PERSEVERANCE 	P ER S AH V IH R AH N S 	p E R s 2 v I r 2 n s 
PERSON 	P ER S AH N 	p E R s 2 n 
PERSONALITY 	P ER S AH N AE L IH T IY 	p E R s 2 n ae l I t i 
PERSPECTIVE 	P ER S P EH K T IH V 	p E R s p E k t I v 
PERSUASION 	P ER S W EY ZH AH N 	p E R s w e I Z 2 n 
PESTICIDE 	P EH S T AH S AY D 	p E s t 2 s E I d 
PET 	P EH T 	p E t 
PETARD 	P EH T ER D 	p E t E R d 
PETITION 	P AH T IH SH AH N 	p 2 t I S 2 n 
PETROL 	P EH T R OW L 	p E t r o U l 
PETROLEUM 	P AH T R OW L IY AH M 	p 2 t r o U l i 2 m 
PETTING 	P EH T IH NG 	p E t I N 
PEWTER 	P Y UW T ER 	p j u t E R 
PHANTOM 	F AE N T AH M 	f ae n t 2 m 
PHARMACY 	F AA R M AH S IY 	f a r m 2 s i 
PHASE 	F EY Z 	f e I z 
PHENOMENON 	F AH N AA M AH N AA N 	f 2 n a m 2 n a n 
PHILOSOPHY 	F AH L AA S AH F IY 	f 2 l a s 2 f i 
PHLOX 	F L AA K S 	f l a k s 
PHOBIA 	F OW B IY AH 	f o U b i 2 
PHOEBE 	F IY B IY 	f i b i 
PHONE 	F OW N 	f o U n 
PHONY 	F OW N IY 	f o U n i 
PHOTO 	F OW T OW 	f o U t o U 
PHOTOGRAPH 	F OW T AH G R AE F 	f o U t 2 g r ae f 
PHOTOGRAPHER 	F AH T AA G R AH F ER 	f 2 t a g r 2 f E R 
PHOTOGRAPHY 	F AH T AA G R AH F IY 	f 2 t a g r 2 f i 
PHRASE 	F R EY Z 	f r e I z 
PHYSICAL 	F IH Z IH K AH L 	f I z I k 2 l 
PHYSICIAN 	F AH Z IH SH AH N 	f 2 z I S 2 n 
PHYSIOTHERAPIST 	F IH S IY AH TH EH R AH P AH S T 	f I s i 2 T E r 2 p 2 s t 
PICK 	P IH K 	p I k 
PICKET 	P IH K IH T 	p I k I t 
PICKETING 	P IH K AH T IH NG 	p I k 2 t I N 
PICKUP 	P IH K AH P 	p I k 2 p 
PICTURE 	P IH K CH ER 	p I k tS E R 
PIE 	P AY 	p E I 
PIECE 	P IY S 	p i s 
PIG 	P IH G 	p I g 
PIGEON 	P IH JH AH N 	p I dZ 2 n 
PILE 	P AY L 	p E I l 
PILLAR 	P IH L ER 	p I l E R 
PILLOW 	P IH L OW 	p I l o U 
PILOT 	P AY L AH T 	p E I l 2 t 
PIN 	P IH N 	p I n 
PINE 	P AY N 	p E I n 
PINKIE 	P IH NG K IY 	p I N k i 
PINKY 	P IH NG K IY 	p I N k i 
PINT 	P AY N T 	p E I n t 
PIONEER 	P AY AH N IH R 	p E I 2 n I r 
PIPE 	P AY P 	p E I p 
PIPELINE 	P AY P L AY N 	p E I p l E I n 
PIPING 	P AY P IH NG 	p E I p I N 
PIRATE 	P AY R AH T 	p E I r 2 t 
PIT 	P IH T 	p I t 
PITCH 	P IH CH 	p I tS 
PITFALL 	P IH T F AO L 	p I t f O l 
PIXEL 	P IH K S AH L 	p I k s 2 l 
PIZZA 	P IY T S AH 	p i t s 2 
PLACE 	P L EY S 	p l e I s 
PLAGUE 	P L EY G 	p l e I g 
PLAIN 	P L EY N 	p l e I n 
PLAN 	P L AE N 	p l ae n 
PLANE 	P L EY N 	p l e I n 
PLANET 	P L AE N AH T 	p l ae n 2 t 
PLANNER 	P L AE N ER 	p l ae n E R 
PLANNING 	P L AE N IH NG 	p l ae n I N 
PLANT 	P L AE N T 	p l ae n t 
PLANTAIN 	P L AE N T AH N 	p l ae n t 2 n 
PLASTER 	P L AE S T ER 	p l ae s t E R 
PLASTIC 	P L AE S T IH K 	p l ae s t I k 
PLATE 	P L EY T 	p l e I t 
PLATFORM 	P L AE T F AO R M 	p l ae t f O r m 
PLATTER 	P L AE T ER 	p l ae t E R 
PLAY 	P L EY 	p l e I 
PLAYER 	P L EY ER 	p l e I E R 
PLAYING 	P L EY IH NG 	p l e I I N 
PLEADING 	P L IY D IH NG 	p l i d I N 
PLEASURE 	P L EH ZH ER 	p l E Z E R 
PLEDGE 	P L EH JH 	p l E dZ 
PLENTY 	P L EH N T IY 	p l E n t i 
PLIGHT 	P L AY T 	p l E I t 
PLOT 	P L AA T 	p l a t 
PLOTTER 	P L AA T ER 	p l a t E R 
PLOVER 	P L AH V ER 	p l 2 v E R 
PLUG 	P L AH G 	p l 2 g 
PLUMBER 	P L AH M ER 	p l 2 m E R 
PLUNGE 	P L AH N JH 	p l 2 n dZ 
PLUS 	P L AH S 	p l 2 s 
PLYWOOD 	P L AY W UH D 	p l E I w U d 
POCKET 	P AA K AH T 	p a k 2 t 
PODIUM 	P OW D IY AH M 	p o U d i 2 m 
POET 	P OW AH T 	p o U 2 t 
POINT 	P OY N T 	p U I n t 
POISON 	P OY Z AH N 	p U I z 2 n 
POISONING 	P OY Z AH N IH NG 	p U I z 2 n I N 
POKER 	P OW K ER 	p o U k E R 
POLE 	P OW L 	p o U l 
POLICE 	P AH L IY S 	p 2 l i s 
POLICEMAN 	P AH L IY S M AH N 	p 2 l i s m 2 n 
POLICY 	P AA L AH S IY 	p a l 2 s i 
POLISH 	P AA L IH SH 	p a l I S 
POLITE 	P AH L AY T 	p 2 l E I t 
POLITICIAN 	P AA L AH T IH SH AH N 	p a l 2 t I S 2 n 
POLITICS 	P AA L AH T IH K S 	p a l 2 t I k s 
POLL 	P OW L 	p o U l 
POLLUTER 	P AH L UW T ER 	p 2 l u t E R 
POLLUTION 	P AH L UW SH AH N 	p 2 l u S 2 n 
POLYGAMY 	P AH L IH G AH M IY 	p 2 l I g 2 m i 
PONY 	P OW N IY 	p o U n i 
POOL 	P UW L 	p u l 
POOP 	P UW P 	p u p 
POOR 	P UW R 	p u r 
POP 	P AA P 	p a p 
POPCORN 	P AA P K AO R N 	p a p k O r n 
POPE 	P OW P 	p o U p 
POPULARITY 	P AA P Y AH L EH R AH T IY 	p a p j 2 l E r 2 t i 
POPULATION 	P AA P Y AH L EY SH AH N 	p a p j 2 l e I S 2 n 
POPULOUS 	P AA P Y AH L AH S 	p a p j 2 l 2 s 
PORCH 	P AO R CH 	p O r tS 
PORK 	P AO R K 	p O r k 
PORT 	P AO R T 	p O r t 
PORTION 	P AO R SH AH N 	p O r S 2 n 
POSE 	P OW Z 	p o U z 
POSITION 	P AH Z IH SH AH N 	p 2 z I S 2 n 
POSSIBILITY 	P AA S AH B IH L AH T IY 	p a s 2 b I l 2 t i 
POST 	P OW S T 	p o U s t 
POSTAGE 	P OW S T AH JH 	p o U s t 2 dZ 
POSTCARD 	P OW S T K AA R D 	p o U s t k a r d 
POSTER 	P OW S T ER 	p o U s t E R 
POSTERITY 	P AA S T EH R AH T IY 	p a s t E r 2 t i 
POSTING 	P OW S T IH NG 	p o U s t I N 
POSTPONEMENT 	P OW S T P OW N M AH N T 	p o U s t p o U n m 2 n t 
POSTURE 	P AA S CH ER 	p a s tS E R 
POT 	P AA T 	p a t 
POTATO 	P AH T EY T OW 	p 2 t e I t o U 
POTENTIAL 	P AH T EH N SH AH L 	p 2 t E n S 2 l 
POTENTIALITY 	P AH T EH N CH IY AE L AH T IY 	p 2 t E n tS i ae l 2 t i 
POTPOURRI 	P OW P UH R IY 	p o U p U r i 
POTTY 	P AA T IY 	p a t i 
POUCH 	P AW CH 	p E U tS 
POUND 	P AW N D 	p E U n d 
POVERTY 	P AA V ER T IY 	p a v E R t i 
POWDER 	P AW D ER 	p E U d E R 
POWER 	P AW ER 	p E U E R 
PRACTICE 	P R AE K T IH S 	p r ae k t I s 
PRAISE 	P R EY Z 	p r e I z 
PRAWN 	P R AO N 	p r O n 
PRAYER 	P R EH R 	p r E r 
PREACHER 	P R IY CH ER 	p r i tS E R 
PREAMBLE 	P R IY AE M B AH L 	p r i ae m b 2 l 
PRECAUTION 	P R IY K AO SH AH N 	p r i k O S 2 n 
PRECONCEPTION 	P R IY K AH N S EH P SH AH N 	p r i k 2 n s E p S 2 n 
PREDATOR 	P R EH D AH T ER 	p r E d 2 t E R 
PREDICTION 	P R IY D IH K SH AH N 	p r i d I k S 2 n 
PREDISPOSITION 	P R IY D IH S P AH Z IH SH AH N 	p r i d I s p 2 z I S 2 n 
PREFERENCE 	P R EH F ER AH N S 	p r E f E R 2 n s 
PREGNANCY 	P R EH G N AH N S IY 	p r E g n 2 n s i 
PREJUDICE 	P R EH JH AH D IH S 	p r E dZ 2 d I s 
PRELUDE 	P R EY L UW D 	p r e I l u d 
PREMISE 	P R EH M IH S 	p r E m I s 
PREMIUM 	P R IY M IY AH M 	p r i m i 2 m 
PREPARATION 	P R EH P ER EY SH AH N 	p r E p E R e I S 2 n 
PREPAREDNESS 	P R IY P EH R AH D N AH S 	p r i p E r 2 d n 2 s 
PREPAYMENT 	P R IY P EY M AH N T 	p r i p e I m 2 n t 
PRESCHOOLER 	P R IY S K UW L ER 	p r i s k u l E R 
PRESENCE 	P R EH Z AH N S 	p r E z 2 n s 
PRESENT 	P R EH Z AH N T 	p r E z 2 n t 
PRESENTATION 	P R EH Z AH N T EY SH AH N 	p r E z 2 n t e I S 2 n 
PRESIDENT 	P R EH Z IH D AH N T 	p r E z I d 2 n t 
PRESS 	P R EH S 	p r E s 
PRESSURE 	P R EH SH ER 	p r E S E R 
PRETENSE 	P R IY T EH N S 	p r i t E n s 
PRETEXT 	P R IY T EH K S T 	p r i t E k s t 
PRETZEL 	P R EH T Z AH L 	p r E t z 2 l 
PREVIEW 	P R IY V Y UW 	p r i v j u 
PREY 	P R EY 	p r e I 
PRICE 	P R AY S 	p r E I s 
PRICING 	P R AY S IH NG 	p r E I s I N 
PRIDE 	P R AY D 	p r E I d 
PRIEST 	P R IY S T 	p r i s t 
PRIMARY 	P R AY M EH R IY 	p r E I m E r i 
PRINCESS 	P R IH N S EH S 	p r I n s E s 
PRINCIPAL 	P R IH N S AH P AH L 	p r I n s 2 p 2 l 
PRINCIPLE 	P R IH N S AH P AH L 	p r I n s 2 p 2 l 
PRINTER 	P R IH N T ER 	p r I n t E R 
PRINTING 	P R IH N T IH NG 	p r I n t I N 
PRIORITY 	P R AY AO R AH T IY 	p r E I O r 2 t i 
PRISON 	P R IH Z AH N 	p r I z 2 n 
PRISONER 	P R IH Z AH N ER 	p r I z 2 n E R 
PRIVACY 	P R AY V AH S IY 	p r E I v 2 s i 
PRIVILEGE 	P R IH V IH L IH JH 	p r I v I l I dZ 
PRIZE 	P R AY Z 	p r E I z 
PRO 	P R OW 	p r o U 
PROBABILITY 	P R AA B AH B IH L AH T IY 	p r a b 2 b I l 2 t i 
PROBATION 	P R OW B EY SH AH N 	p r o U b e I S 2 n 
PROBE 	P R OW B 	p r o U b 
PROBLEM 	P R AA B L AH M 	p r a b l 2 m 
PROCEDURE 	P R AH S IY JH ER 	p r 2 s i dZ E R 
PROCEEDING 	P R AH S IY D IH NG 	p r 2 s i d I N 
PROCEEDINGS 	P R OW S IY D IH NG Z 	p r o U s i d I N z 
PROCESS 	P R AA S EH S 	p r a s E s 
PROCESSING 	P R AA S EH S IH NG 	p r a s E s I N 
PROCESSOR 	P R AA S EH S ER 	p r a s E s E R 
PROCUREMENT 	P R OW K Y UH R M AH N T 	p r o U k j U r m 2 n t 
PROD 	P R AA D 	p r a d 
PRODUCER 	P R AH D UW S ER 	p r 2 d u s E R 
PRODUCT 	P R AA D AH K T 	p r a d 2 k t 
PRODUCTION 	P R AH D AH K SH AH N 	p r 2 d 2 k S 2 n 
PROFESSION 	P R AH F EH SH AH N 	p r 2 f E S 2 n 
PROFESSIONAL 	P R AH F EH SH AH N AH L 	p r 2 f E S 2 n 2 l 
PROFESSIONALISM 	P R AH F EH SH AH N AH L IH Z AH M 	p r 2 f E S 2 n 2 l I z 2 m 
PROFESSOR 	P R AH F EH S ER 	p r 2 f E s E R 
PROFICIENCY 	P R AH F IH SH AH N S IY 	p r 2 f I S 2 n s i 
PROFILE 	P R OW F AY L 	p r o U f E I l 
PROFIT 	P R AA F AH T 	p r a f 2 t 
PROGNOSIS 	P R AA G N OW S AH S 	p r a g n o U s 2 s 
PROGRAM 	P R OW G R AE M 	p r o U g r ae m 
PROGRAMMING 	P R OW G R AE M IH NG 	p r o U g r ae m I N 
PROGRESS 	P R AA G R EH S 	p r a g r E s 
PROJECT 	P R AA JH EH K T 	p r a dZ E k t 
PROLIFERATION 	P R OW L IH F ER EY SH AH N 	p r o U l I f E R e I S 2 n 
PROMISE 	P R AA M AH S 	p r a m 2 s 
PROMOTION 	P R AH M OW SH AH N 	p r 2 m o U S 2 n 
PRONG 	P R AO NG 	p r O N 
PRONUNCIATION 	P R OW N AH N S IY EY SH AH N 	p r o U n 2 n s i e I S 2 n 
PROOF 	P R UW F 	p r u f 
PROPAGANDA 	P R AA P AH G AE N D AH 	p r a p 2 g ae n d 2 
PROPANE 	P R OW P EY N 	p r o U p e I n 
PROPERTY 	P R AA P ER T IY 	p r a p E R t i 
PROPONENT 	P R AH P OW N AH N T 	p r 2 p o U n 2 n t 
PROPORTION 	P R AH P AO R SH AH N 	p r 2 p O r S 2 n 
PROPOSAL 	P R AH P OW Z AH L 	p r 2 p o U z 2 l 
PROPOSITION 	P R AA P AH Z IH SH AH N 	p r a p 2 z I S 2 n 
PROPRIETOR 	P R AH P R AY AH T ER 	p r 2 p r E I 2 t E R 
PROSECUTION 	P R AA S AH K Y UW SH AH N 	p r a s 2 k j u S 2 n 
PROSECUTOR 	P R AA S IH K Y UW T ER 	p r a s I k j u t E R 
PROSPECT 	P R AA S P EH K T 	p r a s p E k t 
PROSPERITY 	P R AA S P EH R AH T IY 	p r a s p E r 2 t i 
PROSTITUTE 	P R AA S T AH T UW T 	p r a s t 2 t u t 
PROTECTION 	P R AH T EH K SH AH N 	p r 2 t E k S 2 n 
PROTEIN 	P R OW T IY N 	p r o U t i n 
PROTEST 	P R OW T EH S T 	p r o U t E s t 
PROTOCOL 	P R OW T AH K AA L 	p r o U t 2 k a l 
PROVIDER 	P R AH V AY D ER 	p r 2 v E I d E R 
PROVINCE 	P R AA V AH N S 	p r a v 2 n s 
PROVISION 	P R AH V IH ZH AH N 	p r 2 v I Z 2 n 
PROVISO 	P R AH V AY Z OW 	p r 2 v E I z o U 
PROVOCATION 	P R AA V AH K EY SH AH N 	p r a v 2 k e I S 2 n 
PRY 	P R AY 	p r E I 
PSEUDONYM 	S UW D AH N IH M 	s u d 2 n I m 
PSYCHIATRIST 	S AH K AY AH T R AH S T 	s 2 k E I 2 t r 2 s t 
PSYCHOLOGY 	S AY K AA L AH JH IY 	s E I k a l 2 dZ i 
PUB 	P AH B 	p 2 b 
PUBLIC 	P AH B L IH K 	p 2 b l I k 
PUBLICATION 	P AH B L IH K EY SH AH N 	p 2 b l I k e I S 2 n 
PUBLISHER 	P AH B L IH SH ER 	p 2 b l I S E R 
PUFF 	P AH F 	p 2 f 
PUFFING 	P AH F IH NG 	p 2 f I N 
PULL 	P UH L 	p U l 
PULLBACK 	P UH L B AE K 	p U l b ae k 
PULLER 	P UH L ER 	p U l E R 
PULSE 	P AH L S 	p 2 l s 
PUMP 	P AH M P 	p 2 m p 
PUMPKIN 	P AH M P K IH N 	p 2 m p k I n 
PUNCH 	P AH N CH 	p 2 n tS 
PUNCTUATION 	P AH NG K CH UW EY SH AH N 	p 2 N k tS u e I S 2 n 
PUNISHMENT 	P AH N IH SH M AH N T 	p 2 n I S m 2 n t 
PUNK 	P AH NG K 	p 2 N k 
PUP 	P AH P 	p 2 p 
PUPPET 	P AH P AH T 	p 2 p 2 t 
PUPPY 	P AH P IY 	p 2 p i 
PURCHASE 	P ER CH AH S 	p E R tS 2 s 
PURPOSE 	P ER P AH S 	p E R p 2 s 
PURSE 	P ER S 	p E R s 
PURSUIT 	P ER S UW T 	p E R s u t 
PUSH 	P UH SH 	p U S 
PUT 	P UH T 	p U t 
PYRAMID 	P IH R AH M IH D 	p I r 2 m I d 
PYTHON 	P AY TH AA N 	p E I T a n 
QUAD 	K W AA D 	k w a d 
QUALIFICATION 	K W AA L AH F AH K EY SH AH N 	k w a l 2 f 2 k e I S 2 n 
QUALITY 	K W AA L AH T IY 	k w a l 2 t i 
QUANTITY 	K W AA N T AH T IY 	k w a n t 2 t i 
QUARTER 	K W AO R T ER 	k w O r t E R 
QUEEN 	K W IY N 	k w i n 
QUERY 	K W IY R IY 	k w i r i 
QUEST 	K W EH S T 	k w E s t 
QUESTION 	K W EH S CH AH N 	k w E s tS 2 n 
QUIET 	K W AY AH T 	k w E I 2 t 
QUIETNESS 	K W AY AH T N AH S 	k w E I 2 t n 2 s 
QUIZ 	K W IH Z 	k w I z 
QUOTE 	K W OW T 	k w o U t 
RABBIT 	R AE B AH T 	r ae b 2 t 
RABBLE 	R AE B AH L 	r ae b 2 l 
RACE 	R EY S 	r e I s 
RACING 	R EY S IH NG 	r e I s I N 
RACISM 	R EY S IH Z AH M 	r e I s I z 2 m 
RACK 	R AE K 	r ae k 
RADAR 	R EY D AA R 	r e I d a r 
RADIATION 	R EY D IY EY SH AH N 	r e I d i e I S 2 n 
RADICAL 	R AE D IH K AH L 	r ae d I k 2 l 
RADIO 	R EY D IY OW 	r e I d i o U 
RAFFLE 	R AE F AH L 	r ae f 2 l 
RAGE 	R EY JH 	r e I dZ 
RAIL 	R EY L 	r e I l 
RAILWAY 	R EY L W EY 	r e I l w e I 
RAIN 	R EY N 	r e I n 
RAINBOW 	R EY N B OW 	r e I n b o U 
RAISING 	R EY Z IH NG 	r e I z I N 
RALLY 	R AE L IY 	r ae l i 
RALLYING 	R AE L IY IH NG 	r ae l i I N 
RAMIFICATION 	R AE M AH F AH K EY SH AH N 	r ae m 2 f 2 k e I S 2 n 
RANCH 	R AE N CH 	r ae n tS 
RANCHER 	R AE N CH ER 	r ae n tS E R 
RANGE 	R EY N JH 	r e I n dZ 
RANGER 	R EY N JH ER 	r e I n dZ E R 
RANK 	R AE NG K 	r ae N k 
RAPE 	R EY P 	r e I p 
RAT 	R AE T 	r ae t 
RATE 	R EY T 	r e I t 
RATING 	R EY T IH NG 	r e I t I N 
RATION 	R AE SH AH N 	r ae S 2 n 
RATTLING 	R AE T L IH NG 	r ae t l I N 
RAY 	R EY 	r e I 
REACH 	R IY CH 	r i tS 
REACTION 	R IY AE K SH AH N 	r i ae k S 2 n 
REACTOR 	R IY AE K T ER 	r i ae k t E R 
READ 	R EH D 	r E d 
READER 	R IY D ER 	r i d E R 
READING 	R IY D IH NG 	r i d I N 
REALIST 	R IY AH L IH S T 	r i 2 l I s t 
REALITY 	R IY AE L AH T IY 	r i ae l 2 t i 
REALM 	R EH L M 	r E l m 
REAR 	R IH R 	r I r 
REASON 	R IY Z AH N 	r i z 2 n 
REASSURANCE 	R IY AH SH UH R AH N S 	r i 2 S U r 2 n s 
REBEL 	R EH B AH L 	r E b 2 l 
REBELLION 	R IH B EH L Y AH N 	r I b E l j 2 n 
REBIRTH 	R IY B ER TH 	r i b E R T 
RECALL 	R IY K AO L 	r i k O l 
RECEIPT 	R IH S IY T 	r I s i t 
RECEIVER 	R AH S IY V ER 	r 2 s i v E R 
RECEPTION 	R IH S EH P SH AH N 	r I s E p S 2 n 
RECEPTIONIST 	R IH S EH P SH AH N IH S T 	r I s E p S 2 n I s t 
RECESSION 	R IH S EH SH AH N 	r I s E S 2 n 
RECIPE 	R EH S AH P IY 	r E s 2 p i 
RECIPIENT 	R AH S IH P IY AH N T 	r 2 s I p i 2 n t 
RECOGNITION 	R EH K AH G N IH SH AH N 	r E k 2 g n I S 2 n 
RECOIL 	R IY K OY L 	r i k U I l 
RECOMMENDATION 	R EH K AH M AH N D EY SH AH N 	r E k 2 m 2 n d e I S 2 n 
RECONCILIATION 	R EH K AH N S IH L IY EY SH AH N 	r E k 2 n s I l i e I S 2 n 
RECONCILING 	R EH K AH N S AY L IH NG 	r E k 2 n s E I l I N 
RECONNAISSANCE 	R IY K AA N AH S AH N S 	r i k a n 2 s 2 n s 
RECONSTRUCTION 	R IY K AH N S T R AH K SH AH N 	r i k 2 n s t r 2 k S 2 n 
RECORD 	R AH K AO R D 	r 2 k O r d 
RECORDING 	R AH K AO R D IH NG 	r 2 k O r d I N 
RECOUNT 	R IH K AW N T 	r I k E U n t 
RECOVERY 	R IH K AH V R IY 	r I k 2 v r i 
RECRUIT 	R AH K R UW T 	r 2 k r u t 
RECRUITING 	R AH K R UW T IH NG 	r 2 k r u t I N 
RECRUITMENT 	R AH K R UW T M AH N T 	r 2 k r u t m 2 n t 
RECTANGLE 	R EH K T AE NG G AH L 	r E k t ae N g 2 l 
RECTOR 	R EH K T ER 	r E k t E R 
RED 	R EH D 	r E d 
REDUCTION 	R IH D AH K SH AH N 	r I d 2 k S 2 n 
REDWOOD 	R EH D W UH D 	r E d w U d 
REEF 	R IY F 	r i f 
REFERENCE 	R EH F ER AH N S 	r E f E R 2 n s 
REFERRAL 	R IH F ER AH L 	r I f E R 2 l 
REFINERY 	R IH F AY N ER IY 	r I f E I n E R i 
REFLECTION 	R AH F L EH K SH AH N 	r 2 f l E k S 2 n 
REFLECTOR 	R IH F L EH K T ER 	r I f l E k t E R 
REFORMER 	R IH F AO R M ER 	r I f O r m E R 
REFRESHMENT 	R AH F R EH SH M AH N T 	r 2 f r E S m 2 n t 
REFRIGERATOR 	R AH F R IH JH ER EY T ER 	r 2 f r I dZ E R e I t E R 
REFUGEE 	R EH F Y UW JH IY 	r E f j u dZ i 
REFUND 	R IH F AH N D 	r I f 2 n d 
REGARD 	R AH G AA R D 	r 2 g a r d 
REGARDS 	R IH G AA R D Z 	r I g a r d z 
REGIME 	R AH ZH IY M 	r 2 Z i m 
REGIMEN 	R EH JH AH M AH N 	r E dZ 2 m 2 n 
REGION 	R IY JH AH N 	r i dZ 2 n 
REGISTRAR 	R EH JH IH S T R AA R 	r E dZ I s t r a r 
REGISTRATION 	R EH JH IH S T R EY SH AH N 	r E dZ I s t r e I S 2 n 
REGRET 	R AH G R EH T 	r 2 g r E t 
REGULAR 	R EH G Y AH L ER 	r E g j 2 l E R 
REGULARITY 	R EH G Y AH L EH R AH T IY 	r E g j 2 l E r 2 t i 
REGULATION 	R EH G Y AH L EY SH AH N 	r E g j 2 l e I S 2 n 
REGULATOR 	R EH G Y AH L EY T ER 	r E g j 2 l e I t E R 
REIN 	R EY N 	r e I n 
REITERATION 	R IY IH T ER EY SH AH N 	r i I t E R e I S 2 n 
REJECTION 	R IH JH EH K SH AH N 	r I dZ E k S 2 n 
RELAPSE 	R IY L AE P S 	r i l ae p s 
RELATION 	R IY L EY SH AH N 	r i l e I S 2 n 
RELATIONSHIP 	R IY L EY SH AH N SH IH P 	r i l e I S 2 n S I p 
RELATIVE 	R EH L AH T IH V 	r E l 2 t I v 
RELAXATION 	R IY L AE K S EY SH AH N 	r i l ae k s e I S 2 n 
RELEASE 	R IY L IY S 	r i l i s 
RELIABILITY 	R IY L AY AH B IH L AH T IY 	r i l E I 2 b I l 2 t i 
RELIANCE 	R IH L AY AH N S 	r I l E I 2 n s 
RELIEF 	R IH L IY F 	r I l i f 
RELIGION 	R IH L IH JH AH N 	r I l I dZ 2 n 
REMAINDER 	R IH M EY N D ER 	r I m e I n d E R 
REMARK 	R IH M AA R K 	r I m a r k 
REMEDY 	R EH M AH D IY 	r E m 2 d i 
REMINDER 	R IY M AY N D ER 	r i m E I n d E R 
REMISSION 	R IY M IH SH AH N 	r i m I S 2 n 
REMNANT 	R EH M N AH N T 	r E m n 2 n t 
REMODEL 	R IY M AA D AH L 	r i m a d 2 l 
REMODELING 	R IH M AA D AH L IH NG 	r I m a d 2 l I N 
REMOVAL 	R IH M UW V AH L 	r I m u v 2 l 
RENEWAL 	R IH N UW AH L 	r I n u 2 l 
RENOVATION 	R EH N AH V EY SH AH N 	r E n 2 v e I S 2 n 
RENT 	R EH N T 	r E n t 
RENTAL 	R EH N T AH L 	r E n t 2 l 
REOPENING 	R IY OW P AH N IH NG 	r i o U p 2 n I N 
REP 	R EH P 	r E p 
REPAIR 	R IH P EH R 	r I p E r 
REPERCUSSION 	R IY P ER K AH SH AH N 	r i p E R k 2 S 2 n 
REPLACEMENT 	R IH P L EY S M AH N T 	r I p l e I s m 2 n t 
REPLICA 	R EH P L IH K AH 	r E p l I k 2 
REPLY 	R IH P L AY 	r I p l E I 
REPORT 	R IY P AO R T 	r i p O r t 
REPORTER 	R IH P AO R T ER 	r I p O r t E R 
REPORTING 	R IY P AO R T IH NG 	r i p O r t I N 
REPRESENTATION 	R EH P R AH Z EH N T EY SH AH N 	r E p r 2 z E n t e I S 2 n 
REPRESENTATIVE 	R EH P R AH Z EH N T AH T IH V 	r E p r 2 z E n t 2 t I v 
REPRISAL 	R IY P R AY Z AH L 	r i p r E I z 2 l 
REPTILE 	R EH P T AY L 	r E p t E I l 
REPUBLIC 	R IY P AH B L AH K 	r i p 2 b l 2 k 
REPUTATION 	R EH P Y AH T EY SH AH N 	r E p j 2 t e I S 2 n 
REQUEST 	R IH K W EH S T 	r I k w E s t 
REQUIREMENT 	R IH K W AY R M AH N T 	r I k w E I r m 2 n t 
RESCUE 	R EH S K Y UW 	r E s k j u 
RESCUER 	R EH S K Y UW ER 	r E s k j u E R 
RESEARCH 	R IY S ER CH 	r i s E R tS 
RESEARCHER 	R IY S ER CH ER 	r i s E R tS E R 
RESEMBLANCE 	R IH Z EH M B L AH N S 	r I z E m b l 2 n s 
RESERVATION 	R EH Z ER V EY SH AH N 	r E z E R v e I S 2 n 
RESERVE 	R IH Z ER V 	r I z E R v 
RESERVOIR 	R EH Z AH V W AA R 	r E z 2 v w a r 
RESIDENCE 	R EH Z IH D AH N S 	r E z I d 2 n s 
RESIDENCY 	R EH Z IH D AH N S IY 	r E z I d 2 n s i 
RESIDENT 	R EH Z IH D AH N T 	r E z I d 2 n t 
RESISTANCE 	R IH Z IH S T AH N S 	r I z I s t 2 n s 
RESOLUTION 	R EH Z AH L UW SH AH N 	r E z 2 l u S 2 n 
RESORT 	R IH Z AO R T 	r I z O r t 
RESOURCE 	R IY S AO R S 	r i s O r s 
RESPECT 	R IH S P EH K T 	r I s p E k t 
RESPECTS 	R IH S P EH K T S 	r I s p E k t s 
RESPONDENT 	R IH S P AA N D AH N T 	r I s p a n d 2 n t 
RESPONSE 	R IH S P AA N S 	r I s p a n s 
RESPONSIBILITY 	R IY S P AA N S AH B IH L AH T IY 	r i s p a n s 2 b I l 2 t i 
RESPONSIVENESS 	R IH S P AA N S IH V N AH S 	r I s p a n s I v n 2 s 
REST 	R EH S T 	r E s t 
RESTAURANT 	R EH S T ER AA N T 	r E s t E R a n t 
RESTORATION 	R EH S T ER EY SH AH N 	r E s t E R e I S 2 n 
RESTRICTION 	R IY S T R IH K SH AH N 	r i s t r I k S 2 n 
RESTRUCTURING 	R IY S T R AH K CH ER IH NG 	r i s t r 2 k tS E R I N 
RESULT 	R IH Z AH L T 	r I z 2 l t 
RESUME 	R IH Z UW M 	r I z u m 
RESUPPLY 	R IY S AH P L AY 	r i s 2 p l E I 
RETAIL 	R IY T EY L 	r i t e I l 
RETAILER 	R IY T EY L ER 	r i t e I l E R 
RETALIATION 	R IY T AE L IY EY SH AH N 	r i t ae l i e I S 2 n 
RETARDATION 	R IY T AA R D EY SH AH N 	r i t a r d e I S 2 n 
RETENTION 	R IY T EH N SH AH N 	r i t E n S 2 n 
RETIREMENT 	R IY T AY ER M AH N T 	r i t E I E R m 2 n t 
RETREAT 	R IY T R IY T 	r i t r i t 
RETRIAL 	R IY T R AY AH L 	r i t r E I 2 l 
RETROSPECT 	R EH T R AH S P EH K T 	r E t r 2 s p E k t 
RETURN 	R IH T ER N 	r I t E R n 
RETURNEE 	R IH T ER N IY 	r I t E R n i 
REVENGE 	R IY V EH N JH 	r i v E n dZ 
REVENUE 	R EH V AH N UW 	r E v 2 n u 
REVERSAL 	R IH V ER S AH L 	r I v E R s 2 l 
REVIEW 	R IY V Y UW 	r i v j u 
REVIEWER 	R IY V Y UW ER 	r i v j u E R 
REVIEWS 	R IY V Y UW Z 	r i v j u z 
REVISION 	R IY V IH ZH AH N 	r i v I Z 2 n 
REVOCATION 	R EH V AH K EY SH AH N 	r E v 2 k e I S 2 n 
REVOLT 	R IH V OW L T 	r I v o U l t 
REVOLUTION 	R EH V AH L UW SH AH N 	r E v 2 l u S 2 n 
REWARD 	R IH W AO R D 	r I w O r d 
RHYTHM 	R IH DH AH M 	r I D 2 m 
RIB 	R IH B 	r I b 
RIBBON 	R IH B AH N 	r I b 2 n 
RICE 	R AY S 	r E I s 
RIDE 	R AY D 	r E I d 
RIDER 	R AY D ER 	r E I d E R 
RIDING 	R AY D IH NG 	r E I d I N 
RIFLE 	R AY F AH L 	r E I f 2 l 
RIFT 	R IH F T 	r I f t 
RIGHT 	R AY T 	r E I t 
RIGHTEOUSNESS 	R AY CH AH S N AH S 	r E I tS 2 s n 2 s 
RIGHTS 	R AY T S 	r E I t s 
RING 	R IH NG 	r I N 
RINGLEADER 	R IH NG L IY D ER 	r I N l i d E R 
RIP 	R IH P 	r I p 
RISE 	R AY Z 	r E I z 
RISK 	R IH S K 	r I s k 
RIVALRY 	R AY V AH L R IY 	r E I v 2 l r i 
RIVER 	R IH V ER 	r I v E R 
ROACH 	R OW CH 	r o U tS 
ROAD 	R OW D 	r o U d 
ROADSIDE 	R OW D S AY D 	r o U d s E I d 
ROBBER 	R AA B ER 	r a b E R 
ROBE 	R OW B 	r o U b 
ROBOT 	R OW B AA T 	r o U b a t 
ROCK 	R AA K 	r a k 
ROCKET 	R AA K AH T 	r a k 2 t 
RODE 	R OW D 	r o U d 
RODENT 	R OW D AH N T 	r o U d 2 n t 
ROGUE 	R OW G 	r o U g 
ROLE 	R OW L 	r o U l 
ROLL 	R OW L 	r o U l 
ROLLBACK 	R OW L B AE K 	r o U l b ae k 
ROMAINE 	R OW M EY N 	r o U m e I n 
ROMANCE 	R OW M AE N S 	r o U m ae n s 
ROOF 	R UW F 	r u f 
ROOFING 	R UW F IH NG 	r u f I N 
ROOM 	R UW M 	r u m 
ROOMFUL 	R UW M F UH L 	r u m f U l 
ROOSTER 	R UW S T ER 	r u s t E R 
ROOT 	R UW T 	r u t 
ROSE 	R OW Z 	r o U z 
ROSETTE 	R AH S EH T 	r 2 s E t 
ROT 	R AA T 	r a t 
ROTATION 	R OW T EY SH AH N 	r o U t e I S 2 n 
ROUGHHOUSE 	R AH F HH AW S 	r 2 f h E U s 
ROUND 	R AW N D 	r E U n d 
ROUTE 	R UW T 	r u t 
ROUTINE 	R UW T IY N 	r u t i n 
ROW 	R OW 	r o U 
RUBBER 	R AH B ER 	r 2 b E R 
RUBBISH 	R AH B IH SH 	r 2 b I S 
RUBBLE 	R AH B AH L 	r 2 b 2 l 
RUDENESS 	R UW D N AH S 	r u d n 2 s 
RUG 	R AH G 	r 2 g 
RULE 	R UW L 	r u l 
RULER 	R UW L ER 	r u l E R 
RULING 	R UW L IH NG 	r u l I N 
RUMOR 	R UW M ER 	r u m E R 
RUN 	R AH N 	r 2 n 
RUNAROUND 	R AH N AH R AW N D 	r 2 n 2 r E U n d 
RUNNER 	R AH N ER 	r 2 n E R 
RUNNING 	R AH N IH NG 	r 2 n I N 
RUT 	R AH T 	r 2 t 
SABER 	S EY B ER 	s e I b E R 
SABOTEUR 	S AE B AH T ER 	s ae b 2 t E R 
SACKING 	S AE K IH NG 	s ae k I N 
SACRIFICE 	S AE K R AH F AY S 	s ae k r 2 f E I s 
SACRISTY 	S AE K R IH S T IY 	s ae k r I s t i 
SADDLE 	S AE D AH L 	s ae d 2 l 
SAFEGUARD 	S EY F G AA R D 	s e I f g a r d 
SAFETY 	S EY F T IY 	s e I f t i 
SAGA 	S AA G AH 	s a g 2 
SAILING 	S EY L IH NG 	s e I l I N 
SAILOR 	S EY L ER 	s e I l E R 
SAKE 	S EY K 	s e I k 
SALAD 	S AE L AH D 	s ae l 2 d 
SALARY 	S AE L ER IY 	s ae l E R i 
SALE 	S EY L 	s e I l 
SALES 	S EY L Z 	s e I l z 
SALESMAN 	S EY L Z M AH N 	s e I l z m 2 n 
SALESPEOPLE 	S EY L Z P IY P AH L 	s e I l z p i p 2 l 
SALESPERSON 	S EY L Z P ER S AH N 	s e I l z p E R s 2 n 
SALON 	S AH L AA N 	s 2 l a n 
SALSA 	S AA L S AH 	s a l s 2 
SALT 	S AO L T 	s O l t 
SALVAGE 	S AE L V AH JH 	s ae l v 2 dZ 
SAMPLE 	S AE M P AH L 	s ae m p 2 l 
SAMPLER 	S AE M P L ER 	s ae m p l E R 
SAMPLING 	S AE M P L IH NG 	s ae m p l I N 
SANCTION 	S AE NG K SH AH N 	s ae N k S 2 n 
SANCTUARY 	S AE NG K CH UW EH R IY 	s ae N k tS u E r i 
SAND 	S AE N D 	s ae n d 
SANDALWOOD 	S AE N D AH L W UH D 	s ae n d 2 l w U d 
SANDBAG 	S AE N D B AE G 	s ae n d b ae g 
SANDWICH 	S AE N D W IH CH 	s ae n d w I tS 
SAP 	S AE P 	s ae p 
SAPLING 	S AE P L IH NG 	s ae p l I N 
SATELLITE 	S AE T AH L AY T 	s ae t 2 l E I t 
SATISFACTION 	S AE T AH S F AE K SH AH N 	s ae t 2 s f ae k S 2 n 
SAUCE 	S AO S 	s O s 
SAUSAGE 	S AO S AH JH 	s O s 2 dZ 
SAVIOUR 	S EY V Y ER 	s e I v j E R 
SAW 	S AO 	s O 
SAYING 	S EY IH NG 	s e I I N 
SCALE 	S K EY L 	s k e I l 
SCALLOP 	S K AE L AH P 	s k ae l 2 p 
SCAM 	S K AE M 	s k ae m 
SCAMPI 	S K AE M P IY 	s k ae m p i 
SCANDAL 	S K AE N D AH L 	s k ae n d 2 l 
SCANNING 	S K AE N IH NG 	s k ae n I N 
SCARE 	S K EH R 	s k E r 
SCENARIO 	S IH N EH R IY OW 	s I n E r i o U 
SCENE 	S IY N 	s i n 
SCENERY 	S IY N ER IY 	s i n E R i 
SCENT 	S EH N T 	s E n t 
SCHEDULE 	S K EH JH UH L 	s k E dZ U l 
SCHEDULED 	S K EH JH UH L D 	s k E dZ U l d 
SCHEDULER 	S K EH JH UH L ER 	s k E dZ U l E R 
SCHEDULING 	S K EH JH UH L IH NG 	s k E dZ U l I N 
SCHEME 	S K IY M 	s k i m 
SCHOLAR 	S K AA L ER 	s k a l E R 
SCHOLARSHIP 	S K AA L ER SH IH P 	s k a l E R S I p 
SCHOOL 	S K UW L 	s k u l 
SCHOOLING 	S K UW L IH NG 	s k u l I N 
SCHTICK 	SH T IH K 	S t I k 
SCIENCE 	S AY AH N S 	s E I 2 n s 
SCIENTIST 	S AY AH N T IH S T 	s E I 2 n t I s t 
SCOOP 	S K UW P 	s k u p 
SCOOPING 	S K UW P IH NG 	s k u p I N 
SCOPE 	S K OW P 	s k o U p 
SCORE 	S K AO R 	s k O r 
SCORING 	S K AO R IH NG 	s k O r I N 
SCORN 	S K AO R N 	s k O r n 
SCRAMBLE 	S K R AE M B AH L 	s k r ae m b 2 l 
SCRAP 	S K R AE P 	s k r ae p 
SCRATCH 	S K R AE CH 	s k r ae tS 
SCRATCHING 	S K R AE CH IH NG 	s k r ae tS I N 
SCREAM 	S K R IY M 	s k r i m 
SCREEN 	S K R IY N 	s k r i n 
SCREW 	S K R UW 	s k r u 
SCRUFF 	S K R AH F 	s k r 2 f 
SCRUTINY 	S K R UW T AH N IY 	s k r u t 2 n i 
SCULPTING 	S K AH L P T IH NG 	s k 2 l p t I N 
SCULPTURE 	S K AH L P CH ER 	s k 2 l p tS E R 
SEA 	S IY 	s i 
SEAFOOD 	S IY F UW D 	s i f u d 
SEAL 	S IY L 	s i l 
SEAMSTRESS 	S IY M S T R IH S 	s i m s t r I s 
SEARCH 	S ER CH 	s E R tS 
SEARCHING 	S ER CH IH NG 	s E R tS I N 
SEA 	S IY  	s i  
SEASON 	S IY Z AH N 	s i z 2 n 
SEAT 	S IY T 	s i t 
SEATING 	S IY T IH NG 	s i t I N 
SECESSION 	S IH S EH SH AH N 	s I s E S 2 n 
SECESSIONIST 	S IH S EH SH AH N IH S T 	s I s E S 2 n I s t 
SECLUSION 	S IH K L UW ZH AH N 	s I k l u Z 2 n 
SECOND 	S EH K AH N D 	s E k 2 n d 
SECRET 	S IY K R AH T 	s i k r 2 t 
SECRETARY 	S EH K R AH T EH R IY 	s E k r 2 t E r i 
SECRETION 	S AH K R IY SH AH N 	s 2 k r i S 2 n 
SECT 	S EH K T 	s E k t 
SECTION 	S EH K SH AH N 	s E k S 2 n 
SECTOR 	S EH K T ER 	s E k t E R 
SECURITY 	S IH K Y UH R AH T IY 	s I k j U r 2 t i 
SEED 	S IY D 	s i d 
SEEKER 	S IY K ER 	s i k E R 
SEGMENT 	S EH G M AH N T 	s E g m 2 n t 
SEIZURE 	S IY ZH ER 	s i Z E R 
SELECTION 	S AH L EH K SH AH N 	s 2 l E k S 2 n 
SELF 	S EH L F 	s E l f 
SELLER 	S EH L ER 	s E l E R 
SEMESTER 	S AH M EH S T ER 	s 2 m E s t E R 
SEMICOLON 	S EH M IY K OW L AH N 	s E m i k o U l 2 n 
SENATE 	S EH N AH T 	s E n 2 t 
SENATOR 	S EH N AH T ER 	s E n 2 t E R 
SEND 	S EH N D 	s E n d 
SENDER 	S EH N D ER 	s E n d E R 
SENSATION 	S EH N S EY SH AH N 	s E n s e I S 2 n 
SENSE 	S EH N S 	s E n s 
SENSITIVITY 	S EH N S IH T IH V IH T IY 	s E n s I t I v I t i 
SENSOR 	S EH N S ER 	s E n s E R 
SENTENCE 	S EH N T AH N S 	s E n t 2 n s 
SENTENCING 	S EH N T AH N S IH NG 	s E n t 2 n s I N 
SENTIMENT 	S EH N T AH M AH N T 	s E n t 2 m 2 n t 
SEPARATION 	S EH P ER EY SH AH N 	s E p E R e I S 2 n 
SEPARATIST 	S EH P ER AH T IH S T 	s E p E R 2 t I s t 
SEQUENCE 	S IY K W AH N S 	s i k w 2 n s 
SERGEANT 	S AA R JH AH N T 	s a r dZ 2 n t 
SERIOUSNESS 	S IH R IY AH S N AH S 	s I r i 2 s n 2 s 
SERPENT 	S ER P AH N T 	s E R p 2 n t 
SERVANT 	S ER V AH N T 	s E R v 2 n t 
SERVER 	S ER V ER 	s E R v E R 
SERVICE 	S ER V AH S 	s E R v 2 s 
SERVING 	S ER V IH NG 	s E R v I N 
SESAME 	S EH S AH M IY 	s E s 2 m i 
SESSION 	S EH SH AH N 	s E S 2 n 
SET 	S EH T 	s E t 
SETBACK 	S EH T B AE K 	s E t b ae k 
SETTING 	S EH T IH NG 	s E t I N 
SETTLEMENT 	S EH T AH L M AH N T 	s E t 2 l m 2 n t 
SETUP 	S EH T AH P 	s E t 2 p 
SEWAGE 	S UW AH JH 	s u 2 dZ 
SEX 	S EH K S 	s E k s 
SHADE 	SH EY D 	S e I d 
SHADOW 	SH AE D OW 	S ae d o U 
SHAFT 	SH AE F T 	S ae f t 
SHAM 	SH AE M 	S ae m 
SHAME 	SH EY M 	S e I m 
SHAMPOO 	SH AE M P UW 	S ae m p u 
SHANK 	SH AE NG K 	S ae N k 
SHAPE 	SH EY P 	S e I p 
SHARE 	SH EH R 	S E r 
SHARK 	SH AA R K 	S a r k 
SHAVE 	SH EY V 	S e I v 
SHED 	SH EH D 	S E d 
SHEDDING 	SH EH D IH NG 	S E d I N 
SHEET 	SH IY T 	S i t 
SHEIK 	SH IY K 	S i k 
SHEIKH 	SH IY K 	S i k 
SHELF 	SH EH L F 	S E l f 
SHELL 	SH EH L 	S E l 
SHELTER 	SH EH L T ER 	S E l t E R 
SHEPHERD 	SH EH P ER D 	S E p E R d 
SHERIFF 	SH EH R AH F 	S E r 2 f 
SHIELD 	SH IY L D 	S i l d 
SHIFT 	SH IH F T 	S I f t 
SHIFTING 	SH IH F T IH NG 	S I f t I N 
SHINE 	SH AY N 	S E I n 
SHIP 	SH IH P 	S I p 
SHIPMENT 	SH IH P M AH N T 	S I p m 2 n t 
SHIPPER 	SH IH P ER 	S I p E R 
SHIPPING 	SH IH P IH NG 	S I p I N 
SHIPYARD 	SH IH P Y AA R D 	S I p j a r d 
SHIRT 	SH ER T 	S E R t 
SHIRTSLEEVE 	SH ER T S L IY V 	S E R t s l i v 
SHIT 	SH IH T 	S I t 
SHOCK 	SH AA K 	S a k 
SHOE 	SH UW 	S u 
SHOOT 	SH UW T 	S u t 
SHOOTING 	SH UW T IH NG 	S u t I N 
SHOP 	SH AA P 	S a p 
SHOPPER 	SH AA P ER 	S a p E R 
SHOPPING 	SH AA P IH NG 	S a p I N 
SHORE 	SH AO R 	S O r 
SHORTAGE 	SH AO R T AH JH 	S O r t 2 dZ 
SHOT 	SH AA T 	S a t 
SHOTGUN 	SH AA T G AH N 	S a t g 2 n 
SHOULDER 	SH OW L D ER 	S o U l d E R 
SHOVEL 	SH AH V AH L 	S 2 v 2 l 
SHOW 	SH OW 	S o U 
SHOWDOWN 	SH OW D AW N 	S o U d E U n 
SHOWER 	SH AW ER 	S E U E R 
SHOWROOM 	SH OW R UH M 	S o U r U m 
SHRAPNEL 	SH R AE P N AH L 	S r ae p n 2 l 
SHRED 	SH R EH D 	S r E d 
SHREWDNESS 	SH R UW D N AH S 	S r u d n 2 s 
SHRIMP 	SH R IH M P 	S r I m p 
SHRINE 	SH R AY N 	S r E I n 
SHRINK 	SH R IH NG K 	S r I N k 
SHRUB 	SH R AH B 	S r 2 b 
SHRUG 	SH R AH G 	S r 2 g 
SHUTTLE 	SH AH T AH L 	S 2 t 2 l 
SICK 	S IH K 	s I k 
SICKNESS 	S IH K N AH S 	s I k n 2 s 
SIDE 	S AY D 	s E I d 
SIDELINE 	S AY D L AY N 	s E I d l E I n 
SIEGE 	S IY JH 	s i dZ 
SIGHT 	S AY T 	s E I t 
SIGN 	S AY N 	s E I n 
SIGNAL 	S IH G N AH L 	s I g n 2 l 
SIGNATORY 	S IH G N AH T AO R IY 	s I g n 2 t O r i 
SIGNATURE 	S IH G N AH CH ER 	s I g n 2 tS E R 
SIGNER 	S AY N ER 	s E I n E R 
SIGNING 	S AY N IH NG 	s E I n I N 
SILK 	S IH L K 	s I l k 
SILKY 	S IH L K IY 	s I l k i 
SILVER 	S IH L V ER 	s I l v E R 
SILVERWARE 	S IH L V ER W EH R 	s I l v E R w E r 
SIMILARITY 	S IH M AH L EH R AH T IY 	s I m 2 l E r 2 t i 
SIMPLIFICATION 	S IH M P L AH F IH K EY SH AH N 	s I m p l 2 f I k e I S 2 n 
SIMULATION 	S IH M Y AH L EY SH AH N 	s I m j 2 l e I S 2 n 
SINGLE 	S IH NG G AH L 	s I N g 2 l 
SINGLES 	S IH NG G AH L Z 	s I N g 2 l z 
SINK 	S IH NG K 	s I N k 
SINKING 	S IH NG K IH NG 	s I N k I N 
SIR 	S ER 	s E R 
SIRLOIN 	S ER L OY N 	s E R l U I n 
SISTER 	S IH S T ER 	s I s t E R 
SIT 	S IH T 	s I t 
SITCOM 	S IH T K AA M 	s I t k a m 
SITE 	S AY T 	s E I t 
SITTING 	S IH T IH NG 	s I t I N 
SITUATION 	S IH CH UW EY SH AH N 	s I tS u e I S 2 n 
SIXTH 	S IH K S TH 	s I k s T 
SIXTY 	S IH K S T IY 	s I k s t i 
SIZE 	S AY Z 	s E I z 
SKATER 	S K EY T ER 	s k e I t E R 
SKILL 	S K IH L 	s k I l 
SKIN 	S K IH N 	s k I n 
SKULL 	S K AH L 	s k 2 l 
SKY 	S K AY 	s k E I 
SKYLIGHT 	S K AY L AY T 	s k E I l E I t 
SLANG 	S L AE NG 	s l ae N 
SLAT 	S L AE T 	s l ae t 
SLAVE 	S L EY V 	s l e I v 
SLAVERY 	S L EY V ER IY 	s l e I v E R i 
SLEEP 	S L IY P 	s l i p 
SLEEPER 	S L IY P ER 	s l i p E R 
SLEEPING 	S L IY P IH NG 	s l i p I N 
SLEEVE 	S L IY V 	s l i v 
SLICE 	S L AY S 	s l E I s 
SLIDE 	S L AY D 	s l E I d 
SLIP 	S L IH P 	s l I p 
SLIVER 	S L IH V ER 	s l I v E R 
SLOT 	S L AA T 	s l a t 
SLUM 	S L AH M 	s l 2 m 
SLUT 	S L AH T 	s l 2 t 
SMELL 	S M EH L 	s m E l 
SMILE 	S M AY L 	s m E I l 
SMIRK 	S M ER K 	s m E R k 
SMOKE 	S M OW K 	s m o U k 
SMOKER 	S M OW K ER 	s m o U k E R 
SMOKING 	S M OW K IH NG 	s m o U k I N 
SMUGGLING 	S M AH G L IH NG 	s m 2 g l I N 
SNACK 	S N AE K 	s n ae k 
SNAFFLE 	S N AE F AH L 	s n ae f 2 l 
SNAIL 	S N EY L 	s n e I l 
SNAKE 	S N EY K 	s n e I k 
SNAP 	S N AE P 	s n ae p 
SNIPER 	S N AY P ER 	s n E I p E R 
SNORKELING 	S N AO R K AH L IH NG 	s n O r k 2 l I N 
SNOW 	S N OW 	s n o U 
SNOWBOARD 	S N OW B AO R D 	s n o U b O r d 
SNOWSTORM 	S N OW S T AO R M 	s n o U s t O r m 
SNUB 	S N AH B 	s n 2 b 
SOAKING 	S OW K IH NG 	s o U k I N 
SOAP 	S OW P 	s o U p 
SOBRIQUET 	S OW B R AH K EY 	s o U b r 2 k e I 
SOCCER 	S AA K ER 	s a k E R 
SOCIALISM 	S OW SH AH L IH Z AH M 	s o U S 2 l I z 2 m 
SOCIALIZATION 	S OW SH AH L IH Z EY SH AH N 	s o U S 2 l I z e I S 2 n 
SOCIETY 	S OW S AY IH T IY 	s o U s E I I t i 
SODA 	S OW D AH 	s o U d 2 
SODIUM 	S OW D IY AH M 	s o U d i 2 m 
SOFA 	S OW F AH 	s o U f 2 
SOFTENER 	S AO F AH N ER 	s O f 2 n E R 
SOFTWARE 	S AO F T W EH R 	s O f t w E r 
SOIL 	S OY L 	s U I l 
SOLDIER 	S OW L JH ER 	s o U l dZ E R 
SOLEMNITY 	S AH L EH M N AH T IY 	s 2 l E m n 2 t i 
SOLID 	S AA L AH D 	s a l 2 d 
SOLIDARITY 	S AA L AH D EH R AH T IY 	s a l 2 d E r 2 t i 
SOLUTION 	S AH L UW SH AH N 	s 2 l u S 2 n 
SOLVING 	S AA L V IH NG 	s a l v I N 
SOMEDAY 	S AH M D EY 	s 2 m d e I 
SOMEPLACE 	S AH M P L EY S 	s 2 m p l e I s 
SOMEWHERE 	S AH M W EH R 	s 2 m w E r 
SON 	S AH N 	s 2 n 
SONG 	S AO NG 	s O N 
SONNY 	S AH N IY 	s 2 n i 
SOPHOMORE 	S AA F M AO R 	s a f m O r 
SORT 	S AO R T 	s O r t 
SOUL 	S OW L 	s o U l 
SOUND 	S AW N D 	s E U n d 
SOUP 	S UW P 	s u p 
SOURCE 	S AO R S 	s O r s 
SOURCING 	S AO R S IH NG 	s O r s I N 
SOUTH 	S AW TH 	s E U T 
SOUTHEAST 	S AW TH IY S T 	s E U T i s t 
SOUVENIR 	S UW V AH N IH R 	s u v 2 n I r 
SOVEREIGNTY 	S AA V R AH N T IY 	s a v r 2 n t i 
SPA 	S P AA 	s p a 
SPACE 	S P EY S 	s p e I s 
SPACECRAFT 	S P EY S K R AE F T 	s p e I s k r ae f t 
SPACEFLIGHT 	S P EY S F L AY T 	s p e I s f l E I t 
SPACEWALK 	S P EY S W AA K 	s p e I s w a k 
SPADEWORK 	S P EY D W ER K 	s p e I d w E R k 
SPAGHETTI 	S P AH G EH T IY 	s p 2 g E t i 
SPARE 	S P EH R 	s p E r 
SPAWNING 	S P AA N IH NG 	s p a n I N 
SPAY 	S P EY 	s p e I 
SPEAK 	S P IY K 	s p i k 
SPEAKER 	S P IY K ER 	s p i k E R 
SPECIAL 	S P EH SH AH L 	s p E S 2 l 
SPECIALIST 	S P EH SH AH L IH S T 	s p E S 2 l I s t 
SPECIFICATION 	S P EH S IH F IH K EY SH AH N 	s p E s I f I k e I S 2 n 
SPECIFICS 	S P IH S IH F IH K S 	s p I s I f I k s 
SPEECH 	S P IY CH 	s p i tS 
SPEED 	S P IY D 	s p i d 
SPELLING 	S P EH L IH NG 	s p E l I N 
SPENDING 	S P EH N D IH NG 	s p E n d I N 
SPHERE 	S F IH R 	s f I r 
SPICE 	S P AY S 	s p E I s 
SPIEL 	S P IY L 	s p i l 
SPIKE 	S P AY K 	s p E I k 
SPIN 	S P IH N 	s p I n 
SPINACH 	S P IH N AH CH 	s p I n 2 tS 
SPINE 	S P AY N 	s p E I n 
SPIRIT 	S P IH R AH T 	s p I r 2 t 
SPIRITUALITY 	S P IH R IH CH UW AE L AH T IY 	s p I r I tS u ae l 2 t i 
SPITE 	S P AY T 	s p E I t 
SPLASH 	S P L AE SH 	s p l ae S 
SPLIT 	S P L IH T 	s p l I t 
SPOILAGE 	S P OY L AH JH 	s p U I l 2 dZ 
SPOKESMAN 	S P OW K S M AH N 	s p o U k s m 2 n 
SPOKESPERSON 	S P OW K S P ER S AH N 	s p o U k s p E R s 2 n 
SPONGE 	S P AH N JH 	s p 2 n dZ 
SPONSORSHIP 	S P AA N S ER SH IH P 	s p a n s E R S I p 
SPOON 	S P UW N 	s p u n 
SPORE 	S P AO R 	s p O r 
SPORT 	S P AO R T 	s p O r t 
SPOT 	S P AA T 	s p a t 
SPOTLIGHT 	S P AA T L AY T 	s p a t l E I t 
SPOUSE 	S P AW S 	s p E U s 
SPRAY 	S P R EY 	s p r e I 
SPRAYING 	S P R EY IH NG 	s p r e I I N 
SPREAD 	S P R EH D 	s p r E d 
SPREADSHEET 	S P R EH D SH IY T 	s p r E d S i t 
SPREE 	S P R IY 	s p r i 
SPRING 	S P R IH NG 	s p r I N 
SPUR 	S P ER 	s p E R 
SPURT 	S P ER T 	s p E R t 
SPY 	S P AY 	s p E I 
SPYING 	S P AY IH NG 	s p E I I N 
SQUADRON 	S K W AA D R AH N 	s k w a d r 2 n 
SQUARE 	S K W EH R 	s k w E r 
SQUEAK 	S K W IY K 	s k w i k 
STABILITY 	S T AH B IH L IH T IY 	s t 2 b I l I t i 
STABILIZATION 	S T EY B AH L AH Z EY SH AH N 	s t e I b 2 l 2 z e I S 2 n 
STABLE 	S T EY B AH L 	s t e I b 2 l 
STADIUM 	S T EY D IY AH M 	s t e I d i 2 m 
STAFF 	S T AE F 	s t ae f 
STAFFS 	S T AE F S 	s t ae f s 
STAGE 	S T EY JH 	s t e I dZ 
STAIN 	S T EY N 	s t e I n 
STAIR 	S T EH R 	s t E r 
STAKE 	S T EY K 	s t e I k 
STALL 	S T AO L 	s t O l 
STAMINA 	S T AE M AH N AH 	s t ae m 2 n 2 
STAMP 	S T AE M P 	s t ae m p 
STAND 	S T AE N D 	s t ae n d 
STANDARD 	S T AE N D ER D 	s t ae n d E R d 
STANDING 	S T AE N D IH NG 	s t ae n d I N 
STANDPOINT 	S T AE N D P OY N T 	s t ae n d p U I n t 
STAPLE 	S T EY P AH L 	s t e I p 2 l 
STAR 	S T AA R 	s t a r 
STARDOM 	S T AA R D AH M 	s t a r d 2 m 
STARE 	S T EH R 	s t E r 
START 	S T AA R T 	s t a r t 
STARTER 	S T AA R T ER 	s t a r t E R 
STARTING 	S T AA R T IH NG 	s t a r t I N 
STARVATION 	S T AA R V EY SH AH N 	s t a r v e I S 2 n 
STATE 	S T EY T 	s t e I t 
STATEMENT 	S T EY T M AH N T 	s t e I t m 2 n t 
STATIC 	S T AE T IH K 	s t ae t I k 
STATION 	S T EY SH AH N 	s t e I S 2 n 
STATIONERY 	S T EY SH AH N EH R IY 	s t e I S 2 n E r i 
STATUE 	S T AE CH UW 	s t ae tS u 
STATURE 	S T AE CH ER 	s t ae tS E R 
STATUS 	S T AE T AH S 	s t ae t 2 s 
STAY 	S T EY 	s t e I 
STEAK 	S T EY K 	s t e I k 
STEAKHOUSE 	S T EY K HH AW S 	s t e I k h E U s 
STEAM 	S T IY M 	s t i m 
STEEL 	S T IY L 	s t i l 
STEER 	S T IH R 	s t I r 
STEERING 	S T IH R IH NG 	s t I r I N 
STEP 	S T EH P 	s t E p 
STEREO 	S T EH R IY OW 	s t E r i o U 
STICK 	S T IH K 	s t I k 
STICKER 	S T IH K ER 	s t I k E R 
STINT 	S T IH N T 	s t I n t 
STIPEND 	S T AY P AH N D 	s t E I p 2 n d 
STIPULATION 	S T IH P Y AH L EY SH AH N 	s t I p j 2 l e I S 2 n 
STIRRUP 	S T ER AH P 	s t E R 2 p 
STOCK 	S T AA K 	s t a k 
STOCKHOLDER 	S T AA K HH OW L D ER 	s t a k h o U l d E R 
STOCKPILE 	S T AA K P AY L 	s t a k p E I l 
STOMACH 	S T AH M AH K 	s t 2 m 2 k 
STONE 	S T OW N 	s t o U n 
STOOGE 	S T UW JH 	s t u dZ 
STOP 	S T AA P 	s t a p 
STORAGE 	S T AO R AH JH 	s t O r 2 dZ 
STORE 	S T AO R 	s t O r 
STOREFRONT 	S T AO R F R AA N T 	s t O r f r a n t 
STORM 	S T AO R M 	s t O r m 
STORY 	S T AO R IY 	s t O r i 
STOVE 	S T OW V 	s t o U v 
STRAIN 	S T R EY N 	s t r e I n 
STRANGER 	S T R EY N JH ER 	s t r e I n dZ E R 
STRATEGY 	S T R AE T AH JH IY 	s t r ae t 2 dZ i 
STREAK 	S T R IY K 	s t r i k 
STREAM 	S T R IY M 	s t r i m 
STREET 	S T R IY T 	s t r i t 
STRENGTH 	S T R EH NG K TH 	s t r E N k T 
STRESS 	S T R EH S 	s t r E s 
STRETCH 	S T R EH CH 	s t r E tS 
STRIDE 	S T R AY D 	s t r E I d 
STRIFE 	S T R AY F 	s t r E I f 
STRIKE 	S T R AY K 	s t r E I k 
STRING 	S T R IH NG 	s t r I N 
STRIPE 	S T R AY P 	s t r E I p 
STRIPPER 	S T R IH P ER 	s t r I p E R 
STROBE 	S T R OW B 	s t r o U b 
STROKE 	S T R OW K 	s t r o U k 
STRONGHOLD 	S T R AO NG HH OW L D 	s t r O N h o U l d 
STRUCTURE 	S T R AH K CH ER 	s t r 2 k tS E R 
STRUCTURING 	S T R AH K CH ER IH NG 	s t r 2 k tS E R I N 
STRUGGLE 	S T R AH G AH L 	s t r 2 g 2 l 
STUB 	S T AH B 	s t 2 b 
STUDENT 	S T UW D AH N T 	s t u d 2 n t 
STUDIO 	S T UW D IY OW 	s t u d i o U 
STUDY 	S T AH D IY 	s t 2 d i 
STUFF 	S T AH F 	s t 2 f 
STUPIDITY 	S T UW P IH D IH T IY 	s t u p I d I t i 
STURDY 	S T ER D IY 	s t E R d i 
STYLE 	S T AY L 	s t E I l 
STYLIST 	S T AY L IH S T 	s t E I l I s t 
SUB 	S AH B 	s 2 b 
SUBCONTINENT 	S AH B K AA N T IH N AH N T 	s 2 b k a n t I n 2 n t 
SUBJECT 	S AH B JH EH K T 	s 2 b dZ E k t 
SUBMARINE 	S AH B M ER IY N 	s 2 b m E R i n 
SUBMISSION 	S AH B M IH SH AH N 	s 2 b m I S 2 n 
SUBPOENA 	S AH P IY N AH 	s 2 p i n 2 
SUBSCRIPTION 	S AH B S K R IH P SH AH N 	s 2 b s k r I p S 2 n 
SUBSIDIARY 	S AH B S IH D IY EH R IY 	s 2 b s I d i E r i 
SUBSIDY 	S AH B S IH D IY 	s 2 b s I d i 
SUBSTANCE 	S AH B S T AH N S 	s 2 b s t 2 n s 
SUBSTANTIATION 	S AH B S T AE N CH IY EY SH AH N 	s 2 b s t ae n tS i e I S 2 n 
SUBSTRATE 	S AH B S T R EY T 	s 2 b s t r e I t 
SUBTERFUGE 	S AH B T ER F Y UW JH 	s 2 b t E R f j u dZ 
SUBURB 	S AH B ER B 	s 2 b E R b 
SUBWAY 	S AH B W EY 	s 2 b w e I 
SUCCESS 	S AH K S EH S 	s 2 k s E s 
SUCCESSOR 	S AH K S EH S ER 	s 2 k s E s E R 
SUFFERING 	S AH F ER IH NG 	s 2 f E R I N 
SUFFIX 	S AH F IH K S 	s 2 f I k s 
SUGAR 	SH UH G ER 	S U g E R 
SUGGESTION 	S AH JH EH S CH AH N 	s 2 dZ E s tS 2 n 
SUICIDE 	S UW AH S AY D 	s u 2 s E I d 
SUIT 	S UW T 	s u t 
SUITCASE 	S UW T K EY S 	s u t k e I s 
SUITE 	S W IY T 	s w i t 
SULFUR 	S AH L F ER 	s 2 l f E R 
SUM 	S AH M 	s 2 m 
SUMMARY 	S AH M ER IY 	s 2 m E R i 
SUMMER 	S AH M ER 	s 2 m E R 
SUMO 	S UW M OW 	s u m o U 
SUMP 	S AH M P 	s 2 m p 
SUN 	S AH N 	s 2 n 
SUNLIGHT 	S AH N L AY T 	s 2 n l E I t 
SUPERIOR 	S UW P IH R IY ER 	s u p I r i E R 
SUPERIORITY 	S UW P IH R IY AO R IH T IY 	s u p I r i O r I t i 
SUPERMARKET 	S UW P ER M AA R K IH T 	s u p E R m a r k I t 
SUPERPOWER 	S UW P ER P AW ER 	s u p E R p E U E R 
SUPERVISOR 	S UW P ER V AY Z ER 	s u p E R v E I z E R 
SUPPLEMENT 	S AH P L AH M AH N T 	s 2 p l 2 m 2 n t 
SUPPLIER 	S AH P L AY ER 	s 2 p l E I E R 
SUPPLY 	S AH P L AY 	s 2 p l E I 
SUPPORT 	S AH P AO R T 	s 2 p O r t 
SUPPORTER 	S AH P AO R T ER 	s 2 p O r t E R 
SUPPOSITION 	S AH P AH Z IH SH AH N 	s 2 p 2 z I S 2 n 
SUPREMACY 	S AH P R EH M AH S IY 	s 2 p r E m 2 s i 
SURFACE 	S ER F AH S 	s E R f 2 s 
SURGE 	S ER JH 	s E R dZ 
SURGEON 	S ER JH AH N 	s E R dZ 2 n 
SURGERY 	S ER JH ER IY 	s E R dZ E R i 
SURPLUS 	S ER P L AH S 	s E R p l 2 s 
SURPRISE 	S ER P R AY Z 	s E R p r E I z 
SURRENDER 	S ER EH N D ER 	s E R E n d E R 
SURVEILLANCE 	S ER V EY L AH N S 	s E R v e I l 2 n s 
SURVEY 	S ER V EY 	s E R v e I 
SURVIVAL 	S ER V AY V AH L 	s E R v E I v 2 l 
SURVIVOR 	S ER V AY V ER 	s E R v E I v E R 
SUSHI 	S UW SH IY 	s u S i 
SUSPECT 	S AH S P EH K T 	s 2 s p E k t 
SUSPENSION 	S AH S P EH N SH AH N 	s 2 s p E n S 2 n 
SUSPICION 	S AH S P IH SH AH N 	s 2 s p I S 2 n 
SWALLOW 	S W AA L OW 	s w a l o U 
SWAP 	S W AA P 	s w a p 
SWEAT 	S W EH T 	s w E t 
SWEEPER 	S W IY P ER 	s w i p E R 
SWEET 	S W IY T 	s w i t 
SWING 	S W IH NG 	s w I N 
SWITCH 	S W IH CH 	s w I tS 
SWITCHBOARD 	S W IH CH B AO R D 	s w I tS b O r d 
SYMBOL 	S IH M B AH L 	s I m b 2 l 
SYMBOLISM 	S IH M B AH L IH Z AH M 	s I m b 2 l I z 2 m 
SYMPATHIZER 	S IH M P AH TH AY Z ER 	s I m p 2 T E I z E R 
SYMPATHY 	S IH M P AH TH IY 	s I m p 2 T i 
SYMPTOM 	S IH M P T AH M 	s I m p t 2 m 
SYNCH 	S IH N CH 	s I n tS 
SYNTHESIS 	S IH N TH AH S AH S 	s I n T 2 s 2 s 
SYSTEM 	S IH S T AH M 	s I s t 2 m 
TABLE 	T EY B AH L 	t e I b 2 l 
TABLET 	T AE B L AH T 	t ae b l 2 t 
TAB 	T AE B  	t ae b  
TACO 	T AA K OW 	t a k o U 
TACTIC 	T AE K T IH K 	t ae k t I k 
TAG 	T AE G 	t ae g 
TAIL 	T EY L 	t e I l 
TAKE 	T EY K 	t e I k 
TAKEOVER 	T EY K OW V ER 	t e I k o U v E R 
TAKING 	T EY K IH NG 	t e I k I N 
TALE 	T EY L 	t e I l 
TALENT 	T AE L AH N T 	t ae l 2 n t 
TALK 	T AO K 	t O k 
TALKING 	T AO K IH NG 	t O k I N 
TANDEM 	T AE N D AH M 	t ae n d 2 m 
TANK 	T AE NG K 	t ae N k 
TANKER 	T AE NG K ER 	t ae N k E R 
TAP 	T AE P 	t ae p 
TAPE 	T EY P 	t e I p 
TARGET 	T AA R G AH T 	t a r g 2 t 
TARIFF 	T EH R AH F 	t E r 2 f 
TASK 	T AE S K 	t ae s k 
TASKING 	T AE S K IH NG 	t ae s k I N 
TASTE 	T EY S T 	t e I s t 
TASTING 	T EY S T IH NG 	t e I s t I N 
TATTOO 	T AE T UW 	t ae t u 
TAVERN 	T AE V ER N 	t ae v E R n 
TAX 	T AE K S 	t ae k s 
TAXI 	T AE K S IY 	t ae k s i 
TAXPAYER 	T AE K S P EY ER 	t ae k s p e I E R 
TEA 	T IY 	t i 
TEACHER 	T IY CH ER 	t i tS E R 
TEACHING 	T IY CH IH NG 	t i tS I N 
TEAM 	T IY M 	t i m 
TECHNICIAN 	T EH K N IH SH AH N 	t E k n I S 2 n 
TECHNIQUE 	T EH K N IY K 	t E k n i k 
TECHNOLOGY 	T EH K N AA L AH JH IY 	t E k n a l 2 dZ i 
TEE 	T IY 	t i 
TEEN 	T IY N 	t i n 
TEENAGER 	T IY N EY JH ER 	t i n e I dZ E R 
TEETH 	T IY TH 	t i T 
TELEPHONE 	T EH L AH F OW N 	t E l 2 f o U n 
TELEPHONY 	T EH L AH F OW N IY 	t E l 2 f o U n i 
TELEVISION 	T EH L AH V IH ZH AH N 	t E l 2 v I Z 2 n 
TEMP 	T EH M P 	t E m p 
TEMPER 	T EH M P ER 	t E m p E R 
TEMPERAMENT 	T EH M P R AH M AH N T 	t E m p r 2 m 2 n t 
TEMPERANCE 	T EH M P ER AH N S 	t E m p E R 2 n s 
TEMPERATURE 	T EH M P R AH CH ER 	t E m p r 2 tS E R 
TEMPLE 	T EH M P AH L 	t E m p 2 l 
TEMPURA 	T EH M P Y AH R AH 	t E m p j 2 r 2 
TEN 	T EH N 	t E n 
TENACITY 	T AH N AE S IH T IY 	t 2 n ae s I t i 
TENANT 	T EH N AH N T 	t E n 2 n t 
TENDENCY 	T EH N D AH N S IY 	t E n d 2 n s i 
TENNIS 	T EH N AH S 	t E n 2 s 
TENSION 	T EH N SH AH N 	t E n S 2 n 
TENT 	T EH N T 	t E n t 
TENTH 	T EH N TH 	t E n T 
TERM 	T ER M 	t E R m 
TERMINAL 	T ER M AH N AH L 	t E R m 2 n 2 l 
TERMINATION 	T ER M AH N EY SH AH N 	t E R m 2 n e I S 2 n 
TERRITORY 	T EH R IH T AO R IY 	t E r I t O r i 
TERROR 	T EH R ER 	t E r E R 
TERRORISM 	T EH R AH R IH Z AH M 	t E r 2 r I z 2 m 
TERRORIST 	T EH R AH R IH S T 	t E r 2 r I s t 
TEST 	T EH S T 	t E s t 
TESTAMENT 	T EH S T AH M AH N T 	t E s t 2 m 2 n t 
TESTIMONY 	T EH S T IH M OW N IY 	t E s t I m o U n i 
TESTING 	T EH S T IH NG 	t E s t I N 
TESTOSTERONE 	T EH S T AA S T ER OW N 	t E s t a s t E R o U n 
TEXT 	T EH K S T 	t E k s t 
TEXTURE 	T EH K S CH ER 	t E k s tS E R 
THANK 	TH AE NG K 	T ae N k 
THAWED 	TH AO D 	T O d 
THEATER 	TH IY EY T ER 	T i e I t E R 
THEATRE 	TH IY AH T ER 	T i 2 t E R 
THEFT 	TH EH F T 	T E f t 
THEME 	TH IY M 	T i m 
THEORY 	TH IH R IY 	T I r i 
THERAPIST 	TH EH R AH P IH S T 	T E r 2 p I s t 
THERAPY 	TH EH R AH P IY 	T E r 2 p i 
THERMOMETER 	TH ER M AA M AH T ER 	T E R m a m 2 t E R 
THESIS 	TH IY S IH S 	T i s I s 
THICKNESS 	TH IH K N AH S 	T I k n 2 s 
THIEF 	TH IY F 	T i f 
THIEVERY 	TH IY V ER IY 	T i v E R i 
THIGH 	TH AY 	T E I 
THING 	TH IH NG 	T I N 
THINK 	TH IH NG K 	T I N k 
THINKING 	TH IH NG K IH NG 	T I N k I N 
THIRD 	TH ER D 	T E R d 
THIRST 	TH ER S T 	T E R s t 
THOUGHT 	TH AO T 	T O t 
THOUSAND 	TH AW Z AH N D 	T E U z 2 n d 
THREAD 	TH R EH D 	T r E d 
THREAT 	TH R EH T 	T r E t 
THREATENED 	TH R EH T AH N D 	T r E t 2 n d 
THRESHOLD 	TH R EH SH OW L D 	T r E S o U l d 
THROAT 	TH R OW T 	T r o U t 
THUG 	TH AH G 	T 2 g 
THUMB 	TH AH M 	T 2 m 
THYROID 	TH AY R OY D 	T E I r U I d 
TICKET 	T IH K AH T 	t I k 2 t 
TIDBIT 	T IH D B IH T 	t I d b I t 
TIDE 	T AY D 	t E I d 
TIE 	T AY 	t E I 
TILE 	T AY L 	t E I l 
TIMBER 	T IH M B ER 	t I m b E R 
TIME 	T AY M 	t E I m 
TIMER 	T AY M ER 	t E I m E R 
TIMETABLE 	T AY M T EY B AH L 	t E I m t e I b 2 l 
TIMING 	T AY M IH NG 	t E I m I N 
TIN 	T IH N 	t I n 
TINT 	T IH N T 	t I n t 
TIP 	T IH P 	t I p 
TIRE 	T AY ER 	t E I E R 
TISSUE 	T IH S Y UW 	t I s j u 
TITLE 	T AY T AH L 	t E I t 2 l 
TOAST 	T OW S T 	t o U s t 
TODAY 	T AH D EY 	t 2 d e I 
TODDLER 	T AA D L ER 	t a d l E R 
TOE 	T OW 	t o U 
TOENAIL 	T OW N EY L 	t o U n e I l 
TOFU 	T OW F UW 	t o U f u 
TOILET 	T OY L AH T 	t U I l 2 t 
TOLL 	T OW L 	t o U l 
TOM 	T AA M 	t a m 
TOMATO 	T AH M EY T OW 	t 2 m e I t o U 
TOMORROW 	T AH M AA R OW 	t 2 m a r o U 
TON 	T AH N 	t 2 n 
TONGUE 	T AH NG 	t 2 N 
TONIGHT 	T AH N AY T 	t 2 n E I t 
TONNAGE 	T AH N AH JH 	t 2 n 2 dZ 
TONNE 	T AH N 	t 2 n 
TOOL 	T UW L 	t u l 
TOOLING 	T UW L IH NG 	t u l I N 
TOOTHACHE 	T UW TH EY K 	t u T e I k 
TOP 	T AA P 	t a p 
TOPIC 	T AA P IH K 	t a p I k 
TORCH 	T AO R CH 	t O r tS 
TORTILLA 	T AO R T IY AH 	t O r t i 2 
TORTURE 	T AO R CH ER 	t O r tS E R 
TOTAL 	T OW T AH L 	t o U t 2 l 
TOTE 	T OW T 	t o U t 
TOUCH 	T AH CH 	t 2 tS 
TOUR 	T UH R 	t U r 
TOURISM 	T UH R IH Z AH M 	t U r I z 2 m 
TOURIST 	T UH R AH S T 	t U r 2 s t 
TOURNAMENT 	T UH R N AH M AH N T 	t U r n 2 m 2 n t 
TOW 	T OW 	t o U 
TOWEL 	T AW AH L 	t E U 2 l 
TOWER 	T AW ER 	t E U E R 
TOWING 	T OW IH NG 	t o U I N 
TOWN 	T AW N 	t E U n 
TOWNHOUSE 	T AW N HH AW S 	t E U n h E U s 
TOWNSHIP 	T AW N SH IH P 	t E U n S I p 
TOXIN 	T AA K S AH N 	t a k s 2 n 
TOY 	T OY 	t U I 
TRACE 	T R EY S 	t r e I s 
TRACK 	T R AE K 	t r ae k 
TRACKING 	T R AE K IH NG 	t r ae k I N 
TRACT 	T R AE K T 	t r ae k t 
TRACTOR 	T R AE K T ER 	t r ae k t E R 
TRADE 	T R EY D 	t r e I d 
TRADEMARK 	T R EY D M AA R K 	t r e I d m a r k 
TRADEMARKING 	T R EY D M AA R K IH NG 	t r e I d m a r k I N 
TRADER 	T R EY D ER 	t r e I d E R 
TRADING 	T R EY D IH NG 	t r e I d I N 
TRADITION 	T R AH D IH SH AH N 	t r 2 d I S 2 n 
TRAFFIC 	T R AE F IH K 	t r ae f I k 
TRAFFICKER 	T R AE F IH K ER 	t r ae f I k E R 
TRAFFICKING 	T R AE F IH K IH NG 	t r ae f I k I N 
TRAGEDY 	T R AE JH AH D IY 	t r ae dZ 2 d i 
TRAIL 	T R EY L 	t r e I l 
TRAILER 	T R EY L ER 	t r e I l E R 
TRAIN 	T R EY N 	t r e I n 
TRAINER 	T R EY N ER 	t r e I n E R 
TRAINING 	T R EY N IH NG 	t r e I n I N 
TRAITOR 	T R EY T ER 	t r e I t E R 
TRANSACTION 	T R AE N Z AE K SH AH N 	t r ae n z ae k S 2 n 
TRANSCENDENCE 	T R AE N S EH N D AH N S 	t r ae n s E n d 2 n s 
TRANSCRIPT 	T R AE N S K R IH P T 	t r ae n s k r I p t 
TRANSFER 	T R AE N S F ER 	t r ae n s f E R 
TRANSFORMATION 	T R AE N S F ER M EY SH AH N 	t r ae n s f E R m e I S 2 n 
TRANSIT 	T R AE N Z IH T 	t r ae n z I t 
TRANSITION 	T R AE N Z IH SH AH N 	t r ae n z I S 2 n 
TRANSLATION 	T R AE N Z L EY SH AH N 	t r ae n z l e I S 2 n 
TRANSMISSION 	T R AE N S M IH SH AH N 	t r ae n s m I S 2 n 
TRANSMUTATION 	T R AE N S M Y UW T EY SH AH N 	t r ae n s m j u t e I S 2 n 
TRANSPORT 	T R AE N S P AO R T 	t r ae n s p O r t 
TRANSPORTATION 	T R AE N S P ER T EY SH AH N 	t r ae n s p E R t e I S 2 n 
TRAP 	T R AE P 	t r ae p 
TRASH 	T R AE SH 	t r ae S 
TRAUMA 	T R AO M AH 	t r O m 2 
TRAVEL 	T R AE V AH L 	t r ae v 2 l 
TRAVELER 	T R AE V AH L ER 	t r ae v 2 l E R 
TRAVELING 	T R AE V AH L IH NG 	t r ae v 2 l I N 
TRAVELLER 	T R AE V AH L ER 	t r ae v 2 l E R 
TRAVELLING 	T R AE V AH L IH NG 	t r ae v 2 l I N 
TRAY 	T R EY 	t r e I 
TREAT 	T R IY T 	t r i t 
TREATMENT 	T R IY T M AH N T 	t r i t m 2 n t 
TREATY 	T R IY T IY 	t r i t i 
TREE 	T R IY 	t r i 
TREND 	T R EH N D 	t r E n d 
TRESS 	T R EH S 	t r E s 
TRIAGE 	T R AY IH JH 	t r E I I dZ 
TRIAL 	T R AY AH L 	t r E I 2 l 
TRIBE 	T R AY B 	t r E I b 
TRIBUTARY 	T R IH B Y AH T EH R IY 	t r I b j 2 t E r i 
TRICK 	T R IH K 	t r I k 
TRICKLE 	T R IH K AH L 	t r I k 2 l 
TRILLION 	T R IH L Y AH N 	t r I l j 2 n 
TRIMMER 	T R IH M ER 	t r I m E R 
TRIO 	T R IY OW 	t r i o U 
TRIP 	T R IH P 	t r I p 
TRIPLET 	T R IH P L AH T 	t r I p l 2 t 
TRIVIA 	T R IH V IY AH 	t r I v i 2 
TRIVIALITY 	T R IH V IY AE L AH T IY 	t r I v i ae l 2 t i 
TROOP 	T R UW P 	t r u p 
TROT 	T R AA T 	t r a t 
TROTTER 	T R AA T ER 	t r a t E R 
TROUBLE 	T R AH B AH L 	t r 2 b 2 l 
TRUCK 	T R AH K 	t r 2 k 
TRUST 	T R AH S T 	t r 2 s t 
TRUSTEE 	T R AH S T IY 	t r 2 s t i 
TRUTH 	T R UW TH 	t r u T 
TRY 	T R AY 	t r E I 
TSAR 	Z AA R 	z a r 
TSUNAMI 	T S UW N AA M IY 	t s u n a m i 
TUB 	T AH B 	t 2 b 
TUBE 	T UW B 	t u b 
TUG 	T AH G 	t 2 g 
TUMOR 	T UW M ER 	t u m E R 
TUNA 	T UW N AH 	t u n 2 
TUNDRA 	T AH N D R AH 	t 2 n d r 2 
TUNING 	T UW N IH NG 	t u n I N 
TURBINE 	T ER B AY N 	t E R b E I n 
TURKEY 	T ER K IY 	t E R k i 
TURMOIL 	T ER M OY L 	t E R m U I l 
TURN 	T ER N 	t E R n 
TURNOVER 	T ER N OW V ER 	t E R n o U v E R 
TUSSOCK 	T AH S AH K 	t 2 s 2 k 
TUTORIAL 	T UW T AO R IY AH L 	t u t O r i 2 l 
TWEEZER 	T W IY Z ER   	t w i z E R 
TWILIGHT 	T W AY L AY T 	t w E I l E I t 
TWIN 	T W IH N 	t w I n 
TWIST 	T W IH S T 	t w I s t 
TYPE 	T AY P 	t E I p 
TYPO 	T AY P OW 	t E I p o U 
TYRANT 	T AY R AH N T 	t E I r 2 n t 
UMBRELLA 	AH M B R EH L AH 	2 m b r E l 2 
UNCERTAINTY 	AH N S ER T AH N T IY 	2 n s E R t 2 n t i 
UNCLE 	AH NG K AH L 	2 N k 2 l 
UNDERCURRENT 	AH N D ER K ER AH N T 	2 n d E R k E R 2 n t 
UNDERGRADUATE 	AH N D ER G R AE JH AH W AH T 	2 n d E R g r ae dZ 2 w 2 t 
UNDERGROUND 	AH N D ER G R AW N D 	2 n d E R g r E U n d 
UNDERSTANDING 	AH N D ER S T AE N D IH NG 	2 n d E R s t ae n d I N 
UNDERWEAR 	AH N D ER W EH R 	2 n d E R w E r 
UNDERWRITING 	AH N D ER R AY T IH NG 	2 n d E R r E I t I N 
UNEASINESS 	AH N IY Z IY N AH S 	2 n i z i n 2 s 
UNIFORM 	Y UW N AH F AO R M 	j u n 2 f O r m 
UNION 	Y UW N Y AH N 	j u n j 2 n 
UNIT 	Y UW N AH T 	j u n 2 t 
UNITY 	Y UW N AH T IY 	j u n 2 t i 
UNIVERSE 	Y UW N AH V ER S 	j u n 2 v E R s 
UNIVERSITY 	Y UW N AH V ER S AH T IY 	j u n 2 v E R s 2 t i 
UNLOADING 	AH N L OW D IH NG 	2 n l o U d I N 
UNWILLINGNESS 	AH N W IH L IH NG N IH S 	2 n w I l I N n I s 
UPBRINGING 	AH P B R IH NG IH NG 	2 p b r I N I N 
UPDATE 	AH P D EY T 	2 p d e I t 
UPGRADE 	AH P G R EY D 	2 p g r e I d 
UPHEAVAL 	AH P HH IY V AH L 	2 p h i v 2 l 
UPLAND 	AH P L AH N D 	2 p l 2 n d 
UPRISING 	AH P R AY Z IH NG 	2 p r E I z I N 
URETHRA 	Y ER IY TH R AH 	j E R i T r 2 
URGE 	ER JH 	E R dZ 
URGING 	ER JH IH NG 	E R dZ I N 
URINAL 	Y UH R AH N AH L 	j U r 2 n 2 l 
URINATION 	Y UH R AH N EY SH AH N 	j U r 2 n e I S 2 n 
URINE 	Y ER AH N 	j E R 2 n 
USAGE 	Y UW S AH JH 	j u s 2 dZ 
USE 	Y UW S 	j u s 
USER 	Y UW Z ER 	j u z E R 
UTENSIL 	Y UW T EH N S AH L 	j u t E n s 2 l 
UTERINE 	Y UW T ER AH N 	j u t E R 2 n 
UTILITARIANISM 	Y UH T IH L AH T EH R IY AH N IH Z AH M 	j U t I l 2 t E r i 2 n I z 2 m 
UTILITY 	Y UW T IH L AH T IY 	j u t I l 2 t i 
VACANCY 	V EY K AH N S IY 	v e I k 2 n s i 
VACATION 	V EY K EY SH AH N 	v e I k e I S 2 n 
VACCINE 	V AE K S IY N 	v ae k s i n 
VACUUM 	V AE K Y UW M 	v ae k j u m 
VALET 	V AE L EY 	v ae l e I 
VALIDITY 	V AH L IH D IH T IY 	v 2 l I d I t i 
VALLEY 	V AE L IY 	v ae l i 
VALUATION 	V AE L Y UW EY SH AH N 	v ae l j u e I S 2 n 
VALUE 	V AE L Y UW 	v ae l j u 
VALVE 	V AE L V 	v ae l v 
VAN 	V AE N 	v ae n 
VANILLA 	V AH N IH L AH 	v 2 n I l 2 
VAPOR 	V EY P ER 	v e I p E R 
VARIETY 	V ER AY AH T IY 	v E R E I 2 t i 
VASTNESS 	V AE S T N AH S 	v ae s t n 2 s 
VEGETABLE 	V EH JH T AH B AH L 	v E dZ t 2 b 2 l 
VEGETARIAN 	V EH JH AH T EH R IY AH N 	v E dZ 2 t E r i 2 n 
VEGGIE 	V EH JH IY 	v E dZ i 
VEHICLE 	V IY HH IH K AH L 	v i h I k 2 l 
VEIL 	V EY L 	v e I l 
VENDOR 	V EH N D ER 	v E n d E R 
VENGEANCE 	V EH N JH AH N S 	v E n dZ 2 n s 
VENT 	V EH N T 	v E n t 
VENTILATION 	V EH N T IH L EY SH AH N 	v E n t I l e I S 2 n 
VENTILATOR 	V EH N T IH L EY T ER 	v E n t I l e I t E R 
VENTURE 	V EH N CH ER 	v E n tS E R 
VENUE 	V EH N Y UW 	v E n j u 
VERDICT 	V ER D IH K T 	v E R d I k t 
VERSION 	V ER ZH AH N 	v E R Z 2 n 
VESSEL 	V EH S AH L 	v E s 2 l 
VEST 	V EH S T 	v E s t 
VET 	V EH T 	v E t 
VETERAN 	V EH T ER AH N 	v E t E R 2 n 
VETERINARIAN 	V EH T R AH N EH R IY AH N 	v E t r 2 n E r i 2 n 
VETO 	V IY T OW 	v i t o U 
VIABILITY 	V AY AH B IH L AH T IY 	v E I 2 b I l 2 t i 
VIAL 	V AY AH L 	v E I 2 l 
VIBE 	V AY B 	v E I b 
VICE 	V AY S 	v E I s 
VICTIM 	V IH K T IH M 	v I k t I m 
VICTORY 	V IH K T AH R IY 	v I k t 2 r i 
VIDEO 	V IH D IY OW 	v I d i o U 
VIDEOTAPE 	V IH D IY OW T EY P 	v I d i o U t e I p 
VIEW 	V Y UW 	v j u 
VIEWER 	V Y UW ER 	v j u E R 
VIEWPOINT 	V Y UW P OY N T 	v j u p U I n t 
VILLAGE 	V IH L AH JH 	v I l 2 dZ 
VINTAGE 	V IH N T IH JH 	v I n t I dZ 
VIOLATION 	V AY AH L EY SH AH N 	v E I 2 l e I S 2 n 
VIOLENCE 	V AY AH L AH N S 	v E I 2 l 2 n s 
VIRILITY 	V ER IH L AH T IY 	v E R I l 2 t i 
VIRTUOSO 	V ER CH UW OW S OW 	v E R tS u o U s o U 
VIRUS 	V AY R AH S 	v E I r 2 s 
VISA 	V IY Z AH 	v i z 2 
VISIBILITY 	V IH Z AH B IH L IH T IY 	v I z 2 b I l I t i 
VISION 	V IH ZH AH N 	v I Z 2 n 
VISIT 	V IH Z IH T 	v I z I t 
VISITOR 	V IH Z IH T ER 	v I z I t E R 
VISUALIZATION 	V IH ZH W AH L AH Z EY SH AH N 	v I Z w 2 l 2 z e I S 2 n 
VITAMIN 	V AY T AH M AH N 	v E I t 2 m 2 n 
VOCAL 	V OW K AH L 	v o U k 2 l 
VOICE 	V OY S 	v U I s 
VOID 	V OY D 	v U I d 
VOLATILITY 	V AA L AH T IH L AH T IY 	v a l 2 t I l 2 t i 
VOLUME 	V AA L Y UW M 	v a l j u m 
VOLUNTEER 	V AA L AH N T IH R 	v a l 2 n t I r 
VOLUNTEERING 	V AO L AH N T IH R IH NG 	v O l 2 n t I r I N 
VOMITING 	V AA M AH T IH NG 	v a m 2 t I N 
VOTE 	V OW T 	v o U t 
VOTER 	V OW T ER 	v o U t E R 
VOTING 	V OW T IH NG 	v o U t I N 
VULNERABILITY 	V AH L N ER AH B IH L IH T IY 	v 2 l n E R 2 b I l I t i 
WADING 	W EY D IH NG 	w e I d I N 
WAFFLE 	W AA F AH L 	w a f 2 l 
WAGER 	W EY JH ER 	w e I dZ E R 
WAGON 	W AE G AH N 	w ae g 2 n 
WAIST 	W EY S T 	w e I s t 
WAIT 	W EY T 	w e I t 
WAITER 	W EY T ER 	w e I t E R 
WAITING 	W EY T IH NG 	w e I t I N 
WAITRESS 	W EY T R AH S 	w e I t r 2 s 
WAIVER 	W EY V ER 	w e I v E R 
WAKE 	W EY K 	w e I k 
WALK 	W AO K 	w O k 
WALKING 	W AO K IH NG 	w O k I N 
WALKWAY 	W AO K W EY 	w O k w e I 
WALL 	W AO L 	w O l 
WALLET 	W AO L AH T 	w O l 2 t 
WALNUT 	W AO L N AH T 	w O l n 2 t 
WANTON 	W AO N T AH N 	w O n t 2 n 
WAR 	W AO R 	w O r 
WARD 	W AO R D 	w O r d 
WAREHOUSE 	W EH R HH AW S 	w E r h E U s 
WARFARE 	W AO R F EH R 	w O r f E r 
WARLORD 	W AO R L AO R D 	w O r l O r d 
WARM 	W AO R M 	w O r m 
WARMING 	W AO R M IH NG 	w O r m I N 
WARMONGER 	W AO R M AA NG G ER 	w O r m a N g E R 
WARMTH 	W AO R M TH 	w O r m T 
WARNING 	W AO R N IH NG 	w O r n I N 
WARRANTY 	W AO R AH N T IY 	w O r 2 n t i 
WARRIOR 	W AO R IY ER 	w O r i E R 
WASH 	W AA SH 	w a S 
WASHER 	W AA SH ER 	w a S E R 
WASP 	W AA S P 	w a s p 
WASTE 	W EY S T 	w e I s t 
WATCH 	W AA CH 	w a tS 
WATCHER 	W AA CH ER 	w a tS E R 
WATER 	W AO T ER 	w O t E R 
WATERFALL 	W AO T ER F AO L 	w O t E R f O l 
WATERFRONT 	W AO T ER F R AH N T 	w O t E R f r 2 n t 
WATT 	W AA T 	w a t 
WAVE 	W EY V 	w e I v 
WAX 	W AE K S 	w ae k s 
WAY 	W EY 	w e I 
WEALTH 	W EH L TH 	w E l T 
WEAPON 	W EH P AH N 	w E p 2 n 
WEATHER 	W EH DH ER 	w E D E R 
WEB 	W EH B 	w E b 
WEBSITE 	W EH B S AY T 	w E b s E I t 
WEDDING 	W EH D IH NG 	w E d I N 
WEDGE 	W EH JH 	w E dZ 
WEEK 	W IY K 	w i k 
WEEKDAY 	W IY K D EY 	w i k d e I 
WEEKEND 	W IY K EH N D 	w i k E n d 
WEIGHT 	W EY T 	w e I t 
WEIRDNESS 	W IH R D N AH S 	w I r d n 2 s 
WELFARE 	W EH L F EH R 	w E l f E r 
WELL 	W EH L 	w E l 
WEST 	W EH S T 	w E s t 
WHATNOT 	W AH T N AA T 	w 2 t n a t 
WHEAT 	W IY T 	w i t 
WHEEL 	W IY L 	w i l 
WHEELER 	W IY L ER 	w i l E R 
WHERE 	W EH R 	w E r 
WHILE 	W AY L 	w E I l 
WHIM 	W IH M 	w I m 
WHITE 	W AY T 	w E I t 
WHITING 	W AY T IH NG 	w E I t I N 
WHOLE 	HH OW L 	h o U l 
WIDTH 	W IH D TH 	w I d T 
WIFE 	W AY F 	w E I f 
WIGHT 	W AY T 	w E I t 
WILD 	W AY L D 	w E I l d 
WILDFLOWER 	W AY L D F L AW ER 	w E I l d f l E U E R 
WILDLIFE 	W AY L D L AY F 	w E I l d l E I f 
WILE 	W AY L 	w E I l 
WILL 	W IH L 	w I l 
WILLINGNESS 	W IH L IH NG N AH S 	w I l I N n 2 s 
WILLOW 	W IH L OW 	w I l o U 
WIND 	W AY N D 	w E I n d 
WINDFALL 	W IH N D F AO L 	w I n d f O l 
WINDOW 	W IH N D OW 	w I n d o U 
WINE 	W AY N 	w E I n 
WING 	W IH NG 	w I N 
WINGER 	W IH NG ER 	w I N E R 
WINNER 	W IH N ER 	w I n E R 
WINTER 	W IH N T ER 	w I n t E R 
WIRE 	W AY ER 	w E I E R 
WIRING 	W AY R IH NG 	w E I r I N 
WISDOM 	W IH Z D AH M 	w I z d 2 m 
WISH 	W IH SH 	w I S 
WIT 	W IH T 	w I t 
WITHDRAWAL 	W IH DH D R AO AH L 	w I D d r O 2 l 
WITNESS 	W IH T N AH S 	w I t n 2 s 
WOK 	W AA K 	w a k 
WOLF 	W UH L F 	w U l f 
WONDER 	W AH N D ER 	w 2 n d E R 
WONDERLAND 	W AH N D ER L AE N D 	w 2 n d E R l ae n d 
WOOD 	W UH D 	w U d 
WOODPECKER 	W UH D P EH K ER 	w U d p E k E R 
WOOL 	W UH L 	w U l 
WOOLLY 	W UH L IY 	w U l i 
WORD 	W ER D 	w E R d 
WORDING 	W ER D IH NG 	w E R d I N 
WORK 	W ER K 	w E R k 
WORKER 	W ER K ER 	w E R k E R 
WORKFORCE 	W ER K F AO R S 	w E R k f O r s 
WORKING 	W ER K IH NG 	w E R k I N 
WORKMANSHIP 	W ER K M AH N SH IH P 	w E R k m 2 n S I p 
WORKPLACE 	W ER K P L EY S 	w E R k p l e I s 
WORKSHEET 	W ER K SH IY T 	w E R k S i t 
WORKSHOP 	W ER K SH AA P 	w E R k S a p 
WORLD 	W ER L D 	w E R l d 
WORM 	W ER M 	w E R m 
WORRY 	W ER IY 	w E R i 
WORSHIP 	W ER SH AH P 	w E R S 2 p 
WORSHIPPER 	W ER SH AH P ER 	w E R S 2 p E R 
WORTH 	W ER TH 	w E R T 
WOUND 	W AW N D 	w E U n d 
WRAPPING 	R AE P IH NG 	r ae p I N 
WRATH 	R AE TH 	r ae T 
WRECK 	R EH K 	r E k 
WRINKLE 	R IH NG K AH L 	r I N k 2 l 
WRITER 	R AY T ER 	r E I t E R 
WRITING 	R AY T IH NG 	r E I t I N 
WRONG 	R AO NG 	r O N 
YAHOO 	Y AA HH UW 	j a h u 
YAM 	Y AE M 	j ae m 
YARD 	Y AA R D 	j a r d 
YARN 	Y AA R N 	j a r n 
YEAR 	Y IH R 	j I r 
YELLING 	Y EH L IH NG 	j E l I N 
YES 	Y EH S 	j E s 
YESTERDAY 	Y EH S T ER D EY 	j E s t E R d e I 
YOGA 	Y OW G AH 	j o U g 2 
YOKE 	Y OW K 	j o U k 
YOU 	Y UW 	j u 
YOUNG 	Y AH NG 	j 2 N 
YOUNGSTER 	Y AH NG S T ER 	j 2 N s t E R 
YOUTH 	Y UW TH 	j u T 
ZEALOT 	Z EH L AH T 	z E l 2 t 
ZEBRA 	Z IY B R AH 	z i b r 2 
ZERO 	Z IY R OW 	z i r o U 
ZINC 	Z IH NG K 	z I N k 
ZONE 	Z OW N 	z o U n 
ZOO 	Z UW 	z u 
ZOOM 	Z UW M 	z u m 
