ABERRATION	AE B ER EY SH AH N
ABILITY	AH B IH L AH T IY
ABOMINATION	AH B AA M AH N EY SH AH N
ABOVE	AH B AH V
ABSENCE	AE B S AH N S
ABSORPTION	AH B Z AO R P SH AH N
ABSORPTION(2)	AH B S AO R P SH AH N
ABSTINENCE	AE B S T AH N AH N S
ABSTRACTION	AE B S T R AE K SH AH N
ABSURDITY	AH B S ER D AH T IY
ABUNDANCE	AH B AH N D AH N S
ABUSE	AH B Y UW S
ABUSE(2)	AH B Y UW Z
ABUSER	AH B Y UW Z ER
ABYSS	AH B IH S
ACCENT	AH K S EH N T
ACCENT(2)	AE K S EH N T
ACCEPTANCE	AE K S EH P T AH N S
ACCEPTANCE(2)	AH K S EH P T AH N S
ACCESS	AE K S EH S
ACCESSIBILITY	AE K S EH S AH B IH L IH T IY
ACCESSORY	AE K S EH S ER IY
ACCIDENT	AE K S AH D AH N T
ACCOMMODATION	AH K AA M AH D EY SH AH N
ACCOMPLICE	AH K AA M P L AH S
ACCOMPLISHMENT	AH K AA M P L IH SH M AH N T
ACCORD	AH K AO R D
ACCOUNT	AH K AW N T
ACCOUNTABILITY	AH K AW N T AH B IH L IH T IY
ACCOUNTANT	AH K AW N T AH N T
ACCOUNTING	AH K AW N T IH NG
ACCOUNTING(2)	AH K AW N IH NG
ACCUMULATION	AH K Y UW M Y AH L EY SH AH N
ACCURACY	AE K Y ER AH S IY
ACHIEVEMENT	AH CH IY V M AH N T
ACIDITY	AH S IH D AH T IY
ACQUAINTANCE	AH K W EY N T AH N S
ACQUISITION	AE K W AH Z IH SH AH N
ACRONYM	AE K R AH N IH M
ACT	AE K T
ACTION	AE K SH AH N
ACTIVIST	AE K T IH V IH S T
ACTIVITY	AE K T IH V IH T IY
ACTRESS	AE K T R AH S
ACUPUNCTURE	AE K Y UW P AH NG K CH ER
ACUPUNCTURIST	AE K Y AH P AH NG K T Y AH R AH S T
ADAPTATION	AE D AH P T EY SH AH N
ADDENDUM	AH D EH N D AH M
ADDICT	AH D IH K T
ADDICT(2)	AE D IH K T
ADDICTION	AH D IH K SH AH N
ADDITION	AH D IH SH AH N
ADDITIVE	AE D IH T IH V
ADDRESS	AE D R EH S
ADHERENT	AH D HH IH R AH N T
ADJUSTMENT	AH JH AH S T M AH N T
ADMINISTRATION	AE D M IH N IH S T R EY SH AH N
ADMINISTRATOR	AH D M IH N IH S T R EY T ER
ADMIRATION	AE D M ER EY SH AH N
ADMISSION	AE D M IH SH AH N
ADMISSION(2)	AH D M IH SH AH N
ADOLESCENT	AE D AH L EH S AH N T
ADOLESCENT(2)	AE D OW L EH S AH N T
ADOPTION	AH D AA P SH AH N
ADULT	AH D AH L T
ADULT(2)	AE D AH L T
ADVANCE	AH D V AE N S
ADVANCEMENT	AH D V AE N S M AH N T
ADVANTAGE	AE D V AE N T IH JH
ADVENTURE	AE D V EH N CH ER
ADVENTURE(2)	AH D V EH N CH ER
ADVERT	AE D V ER T
ADVERTISING	AE D V ER T AY Z IH NG
ADVICE	AE D V AY S
ADVICE(2)	AH D V AY S
ADVISE	AE D V AY Z
ADVISE(2)	AH D V AY Z
ADVISER	AE D V AY Z ER
ADVISOR	AE D V AY Z ER
ADVOCATE	AE D V AH K AH T
ADVOCATE(2)	AE D V AH K EY T
AFFAIR	AH F EH R
AFFECTATION	AE F EH K T EY SH AH N
AFFECTION	AH F EH K SH AH N
AFFILIATE	AH F IH L IY EY T
AFFILIATE(2)	AH F IH L IY AH T
AFFINITY	AH F IH N IH T IY
AFICIONADO	AH F IY SH Y AH N AA D OW
AFTERMATH	AE F T ER M AE TH
AFTERNOON	AE F T ER N UW N
AFTERSHOCK	AE F T ER SH AA K
AGE	EY JH
AGENCY	EY JH AH N S IY
AGENDA	AH JH EH N D AH
AGENT	EY JH AH N T
AGGRAVATION	AE G R AH V EY SH AH N
AGGREGATION	AE G R AH G EY SH AH N
AGGRESSION	AH G R EH SH AH N
AGREEMENT	AH G R IY M AH N T
AHEAD	AH HH EH D
AID	EY D
AIDS	EY D Z
AILMENT	EY L M AH N T
AIM	EY M
AIR	EH R
AIRCRAFT	EH R K R AE F T
AIRFARE	EH R F EH R
AIRLIFT	EH R L IH F T
AIRLINE	EH R L AY N
AIRLINER	EH R L AY N ER
AIRPLANE	EH R P L EY N
AIRPORT	EH R P AO R T
AIRWAY	EH R W EY
ALARM	AH L AA R M
ALCOHOL	AE L K AH HH AA L
ALCOHOLISM	AE L K AH HH AO L IH Z AH M
ALE	EY L
ALERT	AH L ER T
ALGA	AE L G AH
ALIAS	EY L IY AH S
ALIGNMENT	AH L AY N M AH N T
ALL	AO L
ALLEGATION	AE L AH G EY SH AH N
ALLIANCE	AH L AY AH N S
ALLOCATION	AE L AH K EY SH AH N
ALLOWANCE	AH L AW AH N S
ALLY	AE L AY
ALLY(2)	AH L AY
ALTAR	AO L T ER
ALTERATION	AO L T ER EY SH AH N
ALTERNATE	AO L T ER N AH T
ALTERNATE(2)	AO L T ER N EY T
ALTERNATIVE	AO L T ER N AH T IH V
ALTITUDE	AE L T AH T UW D
ALUMINUM	AH L UW M AH N AH M
ALUMNUS	AH L AH M N AH S
AMALGAM	AH M AE L G AH M
AMBASSADOR	AE M B AE S AH D ER
AMBIANCE	AE M B IY AH N S
AMBITION	AE M B IH SH AH N
AMBULANCE	AE M B Y AH L AH N S
AMENDED	AH M EH N D IH D
AMENDMENT	AH M EH N D M AH N T
AMMONIA	AH M OW N Y AH
AMMUNITION	AE M Y AH N IH SH AH N
AMNESTY	AE M N AH S T IY
AMOUNT	AH M AW N T
AMUSE	AH M Y UW Z
AMUSEMENT	AH M Y UW Z M AH N T
ANALYSIS	AE N AE L IH S IH S
ANALYST	AE N AH L IH S T
ANESTHETIC	AE N AH S TH EH T IH K
ANGEL	EY N JH AH L
ANGER	AE NG G ER
ANGLE	AE NG G AH L
ANIMAL	AE N AH M AH L
ANNEX	AE N EH K S
ANNEX(2)	AH N EH K S
ANNEXATION	AE N EH K S EY SH AH N
ANNIVERSARY	AE N AH V ER S ER IY
ANNOUNCEMENT	AH N AW N S M EH N T
ANSWER	AE N S ER
ANT	AE N T
ANTHRAX	AE N TH R AE K S
ANTIBIOTIC	AE N T IY B AY AA T IH K
ANTIBIOTIC(2)	AE N T AY B AY AA T IH K
ANTIPASTO	AE N T AH P AE S T OW
ANTIQUE	AE N T IY K
ANTIQUITY	AE N T IH K W AH T IY
ANYTIME	EH N IY T AY M
ANYWHERE	EH N IY W EH R
ANYWHERE(2)	EH N IY HH W EH R
APARTMENT	AH P AA R T M AH N T
APERTURE	AE P ER CH ER
APOGEE	AE P AH JH IY
APOLOGY	AH P AA L AH JH IY
APPARATUS	AE P ER AE T AH S
APPEAL	AH P IY L
APPEARANCE	AH P IH R AH N S
APPELLATION	AE P AH L EY SH AH N
APPENDIX	AH P EH N D IH K S
APPETITE	AE P AH T AY T
APPETIZER	AE P AH T AY Z ER
APPLIANCE	AH P L AY AH N S
APPLICANT	AE P L IH K AH N T
APPLICATION	AE P L AH K EY SH AH N
APPOINTEE	AH P OY N T IY
APPOINTMENT	AH P OY N T M AH N T
APPRECIATION	AH P R IY SH IY EY SH AH N
APPREHENSION	AE P R IH HH EH N SH AH N
APPRENTICE	AH P R EH N T AH S
APPRENTICE(2)	AH P R EH N T IH S
APPROACH	AH P R OW CH
APPROPRIATION	AH P R OW P R IY EY SH AH N
APPROVAL	AH P R UW V AH L
APPROVED	AH P R UW V D
APPROXIMATION	AH P R AA K S AH M EY SH AH N
APRON	EY P R AH N
AQUARIUM	AH K W EH R IY AH M
ARBITRATION	AA R B IH T R EY SH AH N
ARBITRATOR	AA R B IH T R EY T ER
ARCHIPELAGO	AA R K AH P EH L AH G OW
ARCHIPELAGO(2)	AA R CH AH P AH L EY G OW
ARCHIVE	AA R K AY V
AREA	EH R IY AH
ARENA	ER IY N AH
ARGUMENT	AA R G Y AH M AH N T
ARM	AA R M
ARMAMENT	AA R M AH M AH N T
ARMATURE	AA R M AH CH ER
ARMY	AA R M IY
AROUND	ER AW N D
AROUND(2)	ER AW N
ARRANGEMENT	ER EY N JH M AH N T
ARREST	ER EH S T
ARRIVAL	ER AY V AH L
ARROGANCE	EH R AH G AH N S
ARSENAL	AA R S AH N AH L
ARSENIC	AA R S AH N IH K
ART	AA R T
ARTERY	AA R T ER IY
ARTHRITIS	AA R TH R AY T AH S
ARTHRITIS(2)	AA R TH R AY T IH S
ARTICLE	AA R T AH K AH L
ARTICLE(2)	AA R T IH K AH L
ARTICULATING	AA R T IH K Y AH L EY T IH NG
ARTILLERY	AA R T IH L ER IY
ARTIST	AA R T AH S T
ARTIST(2)	AA R T IH S T
ARTWORK	AA R T W ER K
ASBESTOS	AE S B EH S T AH S
ASPARAGUS	AH S P EH R AH G AH S
ASPECT	AE S P EH K T
ASPEN	AE S P AH N
ASPIRATION	AE S P ER EY SH AH N
ASPIRIN	AE S P R IH N
ASS	AE S
ASSAILANT	AH S EY L AH N T
ASSASSIN	AH S AE S AH N
ASSASSINATION	AH S AE S AH N EY SH AH N
ASSAULT	AH S AO L T
ASSEMBLY	AH S EH M B L IY
ASSERTION	AH S ER SH AH N
ASSESSMENT	AH S EH S M AH N T
ASSET	AE S EH T
ASSIGNMENT	AH S AY N M AH N T
ASSISTANCE	AH S IH S T AH N S
ASSISTANT	AH S IH S T AH N T
ASSOCIATE	AH S OW S IY AH T
ASSOCIATE(2)	AH S OW S IY EY T
ASSOCIATE(3)	AH S OW SH IY AH T
ASSOCIATE(4)	AH S OW SH IY EY T
ASSOCIATION	AH S OW S IY EY SH AH N
ASSOCIATION(2)	AH S OW SH IY EY SH AH N
ASSORTMENT	AH S AO R T M AH N T
ASSUMPTION	AH S AH M P SH AH N
ASSURANCE	AH SH UH R AH N S
ASTRONAUT	AE S T R AH N AA T
ASTRONOMY	AH S T R AA N AH M IY
ATMOSPHERE	AE T M AH S F IH R
ATROCITY	AH T R AA S AH T IY
ATROPHY	AE T R AH F IY
ATTACHMENT	AH T AE CH M AH N T
ATTACK	AH T AE K
ATTEMPT	AH T EH M P T
ATTENDANCE	AH T EH N D AH N S
ATTENDANT	AH T EH N D AH N T
ATTENTION	AH T EH N SH AH N
ATTITUDE	AE T AH T UW D
ATTORNEY	AH T ER N IY
ATTRACTION	AH T R AE K SH AH N
AUCTION	AA K SH AH N
AUCTION(2)	AO K SH AH N
AUDACITY	AA D AE S AH T IY
AUDIENCE	AA D IY AH N S
AUDIENCE(2)	AO D IY AH N S
AUDIO	AA D IY OW
AUDIT	AO D IH T
AUNT	AE N T
AUNT(2)	AO N T
AUSPICES	AO S P IH S IH Z
AUTHOR	AO TH ER
AUTHORITY	AH TH AO R AH T IY
AUTHORIZATION	AO TH ER AH Z EY SH AH N
AUTO	AO T OW
AUTONOMY	AO T AA N AH M IY
AUTONOMY(2)	AH T AA N AH M IY
AUTUMN	AO T AH M
AVAIL	AH V EY L
AVAILABILITY	AH V EY L AH B IH L AH T IY
AVAILABILITY(2)	AH V EY L AH B IH L IH T IY
AVENGER	AH V EH N JH ER
AVERAGE	AE V ER IH JH
AVERAGE(2)	AE V R IH JH
AVERSION	AH V ER ZH AH N
AVIATION	EY V IY EY SH AH N
AVOIDANCE	AH V OY D AH N S
AWARD	AH W AO R D
AWARENESS	AH W EH R N AH S
AWAY	AH W EY
BABY	B EY B IY
BACHELOR	B AE CH AH L ER
BACHELOR(2)	B AE CH L ER
BACK	B AE K
BACKGROUND	B AE K G R AW N D
BACKPACK	B AE K P AE K
BACKSIDE	B AE K S AY D
BACKUP	B AE K AH P
BACTERIOLOGIST	B AE K T AH R IY AA L AH JH AH S T
BAD	B AE D
BADGE	B AE JH
BAG	B AE G
BAGEL	B EY G AH L
BAGGAGE	B AE G IH JH
BAIL	B EY L
BAIT	B EY T
BAKER	B EY K ER
BAKERY	B EY K ER IY
BAKING	B EY K IH NG
BALANCE	B AE L AH N S
BALCONY	B AE L K AH N IY
BALDNESS	B AO L D N AH S
BALL	B AO L
BALLERINA	B AE L ER IY N AH
BALLET	B AE L EY
BALLOT	B AE L AH T
BALLOTING	B AE L AH T IH NG
BALLROOM	B AO L R UW M
BALSA	B AO L S AH
BAN	B AE N
BANANA	B AH N AE N AH
BAND	B AE N D
BANDWIDTH	B AE N D W IH D TH
BANG	B AE NG
BANK	B AE NG K
BANKING	B AE NG K IH NG
BANKRUPTCY	B AE NG K R AH P S IY
BANKRUPTCY(2)	B AE NG K R AH P T S IY
BANNER	B AE N ER
BAR	B AA R
BARBECUE	B AA R B IH K Y UW
BARBER	B AA R B ER
BARBERSHOP	B AA R B ER SH AA P
BARGE	B AA R JH
BARN	B AA R N
BAROMETER	B ER AA M IH T ER
BARREL	B AE R AH L
BARREL(2)	B EH R AH L
BARRIER	B AE R IY ER
BARRIER(2)	B EH R IY ER
BARTENDER	B AA R T EH N D ER
BASE	B EY S
BASEBALL	B EY S B AO L
BASHING	B AE SH IH NG
BASIS	B EY S AH S
BASIS(2)	B EY S IH S
BASKET	B AE S K AH T
BASKING	B AE S K IH NG
BASS	B AE S
BASS(2)	B EY S
BAT	B AE T
BATCH	B AE CH
BATH	B AE TH
BATHING	B EY DH IH NG
BATHROOM	B AE TH R UW M
BATTER	B AE T ER
BATTERY	B AE T ER IY
BATTLE	B AE T AH L
BATTLEFIELD	B AE T AH L F IY L D
BAY	B EY
BEACH	B IY CH
BEAK	B IY K
BEAM	B IY M
BEAN	B IY N
BEAR	B EH R
BEARD	B IH R D
BEAT	B IY T
BEATING	B IY T IH NG
BEAUTY	B Y UW T IY
BEAVER	B IY V ER
BED	B EH D
BEDDING	B EH D IH NG
BEDLAM	B EH D L AH M
BEDROOM	B EH D R UW M
BEE	B IY
BEEF	B IY F
BEER	B IH R
BEGINNER	B IH G IH N ER
BEGINNING	B IH G IH N IH NG
BEHALF	B IH HH AE F
BEHAVIOR	B IH HH EY V Y ER
BEING	B IY IH NG
BELIEF	B IH L IY F
BELIEVER	B IH L IY V ER
BELL	B EH L
BELLY	B EH L IY
BELT	B EH L T
BENCH	B EH N CH
BENEFICIARY	B EH N AH F IH SH IY EH R IY
BENEFIT	B EH N AH F IH T
BERRY	B EH R IY
BET	B EH T
BETA	B EY T AH
BEVERAGE	B EH V ER IH JH
BEVERAGE(2)	B EH V R IH JH
BICYCLE	B AY S IH K AH L
BID	B IH D
BIDDER	B IH D ER
BIKE	B AY K
BILL	B IH L
BILLIARDS	B IH L Y ER D Z
BILLING	B IH L IH NG
BILLION	B IH L Y AH N
BINARY	B AY N AH R IY
BIND	B AY N D
BIOCHEMIST	B AY OW K EH M IH S T
BIOLOGIST	B AY AA L AH JH IH S T
BIOLOGY	B AY AA L AH JH IY
BIOSPHERE	B AY OW S F IH R
BIRD	B ER D
BIRDIE	B ER D IY
BIRTH	B ER TH
BIRTHDAY	B ER TH D EY
BIT	B IH T
BITE	B AY T
BITING	B AY T IH NG
BITMAP	B IH T M AE P
BLACK	B L AE K
BLACKMAIL	B L AE K M EY L
BLACKOUT	B L AE K AW T
BLADDER	B L AE D ER
BLADE	B L EY D
BLAME	B L EY M
BLANKET	B L AE NG K AH T
BLANKET(2)	B L AE NG K IH T
BLAST	B L AE S T
BLEND	B L EH N D
BLENDER	B L EH N D ER
BLESSING	B L EH S IH NG
BLINDFOLD	B L AY N D F OW L D
BLINDNESS	B L AY N D N AH S
BLOCK	B L AA K
BLOG	B L AO G
BLOOD	B L AH D
BLOSSOMING	B L AA S AH M IH NG
BLOW	B L OW
BLOWER	B L OW ER
BLOWING	B L OW IH NG
BLOWOUT	B L OW AW T
BLUE	B L UW
BLUFF	B L AH F
BLUNDER	B L AH N D ER
BOARD	B AO R D
BOARDER	B AO R D ER
BOARDING	B AO R D IH NG
BOARDROOM	B AO R D R UW M
BOAST	B OW S T
BOAT	B OW T
BODICE	B AA D IH S
BODY	B AA D IY
BODYGUARD	B AA D IY G AA R D
BOIL	B OY L
BOMB	B AA M
BOMB(2)	B AO M
BOMBAST	B AA M B AE S T
BOMBER	B AA M ER
BOMBING	B AA M IH NG
BOMBS	B AA M Z
BOND	B AA N D
BONE	B OW N
BONUS	B OW N AH S
BOOB	B UW B
BOOK	B UH K
BOOKING	B UH K IH NG
BOOST	B UW S T
BOOSTER	B UW S T ER
BOOT	B UW T
BOOTH	B UW TH
BORDER	B AO R D ER
BORE	B AO R
BOSS	B AA S
BOSS(2)	B AO S
BOTTLE	B AA T AH L
BOTTOM	B AA T AH M
BOULEVARD	B UH L AH V AA R D
BOUNCE	B AW N S
BOUND	B AW N D
BOUT	B AW T
BOUTIQUE	B UW T IY K
BOWEL	B AW AH L
BOWL	B OW L
BOX	B AA K S
BOXER	B AA K S ER
BOY	B OY
BOYCOTT	B OY K AA T
BOYFRIEND	B OY F R EH N D
BOZO	B OW Z OW
BRAIN	B R EY N
BRAINWASHING	B R EY N W AA SH IH NG
BRAKE	B R EY K
BRANCH	B R AE N CH
BRAND	B R AE N D
BRAS	B R AE S
BRAS(2)	B R AA S
BRASS	B R AE S
BRAT	B R AE T
BRAVERY	B R EY V ER IY
BREAD	B R EH D
BREAK	B R EY K
BREAKDOWN	B R EY K D AW N
BREAKFAST	B R EH K F AH S T
BREAKING	B R EY K IH NG
BREAKTHROUGH	B R EY K TH R UW
BREAST	B R EH S T
BREATH	B R EH TH
BREATHING	B R IY DH IH NG
BREED	B R IY D
BREEDER	B R IY D ER
BREEDING	B R IY D IH NG
BREEZE	B R IY Z
BREWERY	B R UW ER IY
BRICK	B R IH K
BRIDE	B R AY D
BRIDGE	B R IH JH
BRIEF	B R IY F
BRIEFING	B R IY F IH NG
BRIGADE	B R AH G EY D
BRIGADE(2)	B R IH G EY D
BRIGHTNESS	B R AY T N AH S
BRINK	B R IH NG K
BRINKMANSHIP	B R IH NG K M AH N SH IH P
BROCCOLI	B R AA K AH L IY
BROCCOLI(2)	B R AA K L IY
BROCHURE	B R OW SH UH R
BROKER	B R OW K ER
BROKERAGE	B R OW K ER IH JH
BROKERAGE(2)	B R OW K R IH JH
BRONZE	B R AA N Z
BROTHEL	B R AA TH AH L
BROTHER	B R AH DH ER
BROWN	B R AW N
BROWSER	B R AW Z ER
BRUISE	B R UW Z
BRUNCH	B R AH N CH
BRUNT	B R AH N T
BUBBLE	B AH B AH L
BUCK	B AH K
BUCKET	B AH K IH T
BUDDY	B AH D IY
BUDGET	B AH JH IH T
BUDGIE	B AH JH IY
BUG	B AH G
BUILD	B IH L D
BUILDER	B IH L D ER
BUILDING	B IH L D IH NG
BUILDUP	B IH L D AH P
BULB	B AH L B
BULL	B UH L
BULLET	B UH L AH T
BULLETIN	B UH L IH T AH N
BULLFIGHT	B UH L F AY T
BULLSHIT	B UH L SH IH T
BUN	B AH N
BUNCH	B AH N CH
BUNDLE	B AH N D AH L
BUNGLING	B AH NG G AH L IH NG
BUNGLING(2)	B AH NG G L IH NG
BURDEN	B ER D AH N
BUREAU	B Y UH R OW
BURGER	B ER G ER
BURGLAR	B ER G L ER
BURIAL	B EH R IY AH L
BURN	B ER N
BURNER	B ER N ER
BURST	B ER S T
BUS	B AH S
BUSH	B UH SH
BUSINESS	B IH Z N AH S
BUSINESS(2)	B IH Z N IH S
BUSTER	B AH S T ER
BUSTLE	B AH S AH L
BUSYBODY	B IH Z IY B AA D IY
BUT	B AH T
BUTT	B AH T
BUTTER	B AH T ER
BUTTERFLY	B AH T ER F L AY
BUTTON	B AH T AH N
BUY	B AY
BUYER	B AY ER
BUYING	B AY IH NG
BUZZING	B AH Z IH NG
CAB	K AE B
CABBAGE	K AE B AH JH
CABBAGE(2)	K AE B IH JH
CABIN	K AE B AH N
CABINET	K AE B AH N AH T
CABINET(2)	K AE B N AH T
CACHE	K AE SH
CACHE(2)	K AE SH EY
CACTUS	K AE K T AH S
CAFETERIA	K AE F AH T IH R IY AH
CAGE	K EY JH
CAKE	K EY K
CALCIUM	K AE L S IY AH M
CALCULATION	K AE L K Y AH L EY SH AH N
CALENDAR	K AE L AH N D ER
CALF	K AE F
CALICO	K AE L AH K OW
CALL	K AO L
CALLING	K AO L IH NG
CALMNESS	K AA M N AH S
CALMNESS(2)	K AA L M N AH S
CAMEL	K AE M AH L
CAMERA	K AE M ER AH
CAMERA(2)	K AE M R AH
CAMP	K AE M P
CAMPAIGN	K AE M P EY N
CAMPAIGNING	K AE M P EY N IH NG
CAMPER	K AE M P ER
CAMPSITE	K AE M P S AY T
CAMPUS	K AE M P AH S
CAN	K AE N
CAN(2)	K AH N
CANAL	K AH N AE L
CANCELLATION	K AE N S AH L EY SH AH N
CANCER	K AE N S ER
CANDIDATE	K AE N D AH D EY T
CANDIDATE(2)	K AE N AH D IH T
CANDLE	K AE N D AH L
CANDY	K AE N D IY
CANISTER	K AE N AH S T ER
CANISTER(2)	K AE N IH S T ER
CANNIBAL	K AE N AH B AH L
CANNON	K AE N AH N
CANOE	K AH N UW
CAP	K AE P
CAPABILITY	K EY P AH B IH L AH T IY
CAPACITY	K AH P AE S AH T IY
CAPACITY(2)	K AH P AE S IH T IY
CAPE	K EY P
CAPER	K EY P ER
CAPITAL	K AE P IH T AH L
CAPSULE	K AE P S AH L
CAPTAIN	K AE P T AH N
CAPTURE	K AE P CH ER
CAR	K AA R
CARBON	K AA R B AH N
CARCINOMA	K AA R S AH N OW M AH
CARD	K AA R D
CARE	K EH R
CAREER	K ER IH R
CARGO	K AA R G OW
CARING	K EH R IH NG
CAROTID	K ER AA T IH D
CARPENTER	K AA R P AH N T ER
CARPET	K AA R P AH T
CARRIER	K AE R IY ER
CARRIER(2)	K EH R IY ER
CARROT	K AE R AH T
CARROT(2)	K EH R AH T
CARTON	K AA R T AH N
CARTOON	K AA R T UW N
CASCADE	K AE S K EY D
CASE	K EY S
CASH	K AE SH
CASHIER	K AE SH IH R
CASINO	K AH S IY N OW
CAST	K AE S T
CASTING	K AE S T IH NG
CASTLING	K AE S T L IH NG
CASUALTY	K AE ZH AH W AH L T IY
CASUALTY(2)	K AE ZH AH L T IY
CAT	K AE T
CATALOGUE	K AE T AH L AO G
CATASTROPHE	K AH T AE S T R AH F IY
CATCH	K AE CH
CATEGORY	K AE T AH G AO R IY
CATER	K EY T ER
CATERING	K EY T ER IH NG
CATFISH	K AE T F IH SH
CATTLE	K AE T AH L
CAULDRON	K AA L D R AH N
CAULDRON(2)	K AO L D R AH N
CAULIFLOWER	K AA L AH F L AW ER
CAUSE	K AA Z
CAUSE(2)	K AO Z
CAVE	K EY V
CEASEFIRE	S IY S F AY ER
CEILING	S IY L IH NG
CELEBRATION	S EH L AH B R EY SH AH N
CELEBRITY	S AH L EH B R IH T IY
CELERY	S EH L ER IY
CELL	S EH L
CEMENT	S AH M EH N T
CEMENT(2)	S IH M EH N T
CENT	S EH N T
CENTER	S EH N T ER
CENTER(2)	S EH N ER
CENTURY	S EH N CH ER IY
CEREAL	S IH R IY AH L
CERTAINTY	S ER T AH N T IY
CERTIFICATE	S ER T IH F IH K AH T
CERTIFICATION	S ER T AH F AH K EY SH AH N
CHAIN	CH EY N
CHAIR	CH EH R
CHAIRMAN	CH EH R M AH N
CHAIRPERSON	CH EH R P ER S AH N
CHALLENGE	CH AE L AH N JH
CHAMBER	CH EY M B ER
CHAMBERMAID	CH EY M B ER M EY D
CHANCE	CH AE N S
CHANDELIER	SH AE N D AH L IH R
CHANGE	CH EY N JH
CHANGING	CH EY N JH IH NG
CHANNEL	CH AE N AH L
CHANT	CH AE N T
CHAOS	K EY AA S
CHAP	CH AE P
CHAPEL	CH AE P AH L
CHAPTER	CH AE P T ER
CHARACTER	K EH R IH K T ER
CHARCOAL	CH AA R K OW L
CHARGE	CH AA R JH
CHARITY	CH EH R IH T IY
CHARM	CH AA R M
CHART	CH AA R T
CHASE	CH EY S
CHASM	K AE Z AH M
CHAT	CH AE T
CHAUVINISM	SH OW V AH N IH Z AH M
CHECK	CH EH K
CHECKOUT	CH EH K AW T
CHEEK	CH IY K
CHEER	CH IH R
CHEESE	CH IY Z
CHEF	SH EH F
CHEMICAL	K EH M IH K AH L
CHEMISTRY	K EH M IH S T R IY
CHESS	CH EH S
CHEST	CH EH S T
CHEW	CH UW
CHICK	CH IH K
CHICKEN	CH IH K AH N
CHIEF	CH IY F
CHIEFS	CH IY F S
CHILD	CH AY L D
CHILDBIRTH	CH AY L D B ER TH
CHILDCARE	CH AY L D K EH R
CHILDHOOD	CH AY L D HH UH D
CHILI	CH IH L IY
CHIP	CH IH P
CHLORIDE	K L AO R AY D
CHLORINATION	K L OW R IY N EY SH AH N
CHLORINE	K L AO R IY N
CHOCOLATE	CH AO K L AH T
CHOICE	CH OY S
CHOIR	K W AY ER
CHORD	K AO R D
CHORE	CH AO R
CHROME	K R OW M
CHUNK	CH AH NG K
CHURCH	CH ER CH
CIGARETTE	S IH G AH R EH T
CINEMA	S IH N AH M AH
CIRCLE	S ER K AH L
CIRCUMSTANCE	S ER K AH M S T AE N S
CITIZEN	S IH T AH Z AH N
CITIZEN(2)	S IH T IH Z AH N
CITIZENSHIP	S IH T IH Z AH N SH IH P
CITY	S IH T IY
CIVET	S IH V AH T
CIVILIAN	S AH V IH L Y AH N
CIVILIZATION	S IH V AH L IH Z EY SH AH N
CLAIM	K L EY M
CLAMORING	K L AE M ER IH NG
CLAMP	K L AE M P
CLAN	K L AE N
CLARIFICATION	K L EH R AH F AH K EY SH AH N
CLASH	K L AE SH
CLASS	K L AE S
CLASSIC	K L AE S IH K
CLASSMATE	K L AE S M EY T
CLAUSE	K L AO Z
CLAW	K L AO
CLAY	K L EY
CLEAN	K L IY N
CLEANER	K L IY N ER
CLEANING	K L IY N IH NG
CLERGY	K L ER JH IY
CLERIC	K L EH R IH K
CLERK	K L ER K
CLIENT	K L AY AH N T
CLIMATE	K L AY M AH T
CLIMATE(2)	K L AY M IH T
CLIMBER	K L AY M ER
CLINIC	K L IH N IH K
CLIP	K L IH P
CLOAK	K L OW K
CLOCK	K L AA K
CLOCKWORK	K L AA K W ER K
CLOSE	K L OW S
CLOSE(2)	K L OW Z
CLOSING	K L OW Z IH NG
CLOTH	K L AO TH
CLOTHES	K L OW DH Z
CLOTHES(2)	K L OW Z
CLOTHING	K L OW DH IH NG
CLOUD	K L AW D
CLUB	K L AH B
CLUBHOUSE	K L AH B HH AW S
CLUE	K L UW
CLUMP	K L AH M P
CLUSTER	K L AH S T ER
COACH	K OW CH
COAL	K OW L
COALITION	K OW AH L IH SH AH N
COAST	K OW S T
COASTAL	K OW S T AH L
COASTLINE	K OW S T L AY N
COAT	K OW T
COATING	K OW T IH NG
COB	K AA B
COCKTAIL	K AA K T EY L
COCONUT	K OW K AH N AH T
COD	K AA D
COD(2)	S IY OW D IY
CODE	K OW D
CODING	K OW D IH NG
COFFEE	K AA F IY
COFFEE(2)	K AO F IY
COFFIN	K AO F IH N
COIN	K OY N
COINCIDENCE	K OW IH N S IH D AH N S
COLLABORATION	K AH L AE B ER EY SH AH N
COLLAGE	K AH L AA ZH
COLLAPSE	K AH L AE P S
COLLAR	K AA L ER
COLLATERAL	K AH L AE T ER AH L
COLLEAGUE	K AA L IY G
COLLECTION	K AH L EH K SH AH N
COLLEGE	K AA L IH JH
COLLISION	K AH L IH ZH AH N
COLLUSION	K AH L UW ZH AH N
COLONIZATION	K AA L AH N IH Z EY SH AH N
COLONY	K AA L AH N IY
COLOR	K AH L ER
COLOR(2)	K AO L ER
COLUMN	K AA L AH M
COLUMNIST	K AA L AH M N AH S T
COMB	K OW M
COMBAT	K AA M B AE T
COMBAT(2)	K AH M B AE T
COMBATANT	K AH M B AE T AH N T
COMBINATION	K AA M B AH N EY SH AH N
COMBO	K AA M B OW
COMEDIAN	K AH M IY D IY AH N
COMEDY	K AA M AH D IY
COMER	K AH M ER
COMFORT	K AH M F ER T
COMMA	K AA M AH
COMMAND	K AH M AE N D
COMMANDER	K AH M AE N D ER
COMMENT	K AA M EH N T
COMMENTARY	K AA M AH N T EH R IY
COMMENTATOR	K AA M AH N T EY T ER
COMMERCIAL	K AH M ER SH AH L
COMMISSION	K AH M IH SH AH N
COMMISSIONER	K AH M IH SH AH N ER
COMMITMENT	K AH M IH T M AH N T
COMMITTEE	K AH M IH T IY
COMMODITY	K AH M AA D AH T IY
COMMUNICATION	K AH M Y UW N AH K EY SH AH N
COMMUNICATOR	K AH M Y UW N AH K EY T ER
COMMUNITY	K AH M Y UW N AH T IY
COMMUNITY(2)	K AH M Y UW N IH T IY
COMPANIES	K AH M P AH N IY Z
COMPANION	K AH M P AE N Y AH N
COMPANY	K AH M P AH N IY
COMPARISON	K AH M P EH R AH S AH N
COMPASSION	K AH M P AE SH AH N
COMPENSATION	K AA M P AH N S EY SH AH N
COMPETITION	K AA M P AH T IH SH AH N
COMPLAINT	K AH M P L EY N T
COMPLETION	K AH M P L IY SH AH N
COMPLEX	K AA M P L EH K S
COMPLEX(2)	K AH M P L EH K S
COMPLEXITY	K AH M P L EH K S AH T IY
COMPLEXITY(2)	K AH M P L EH K S IH T IY
COMPLIANCE	K AH M P L AY AH N S
COMPLICATION	K AA M P L AH K EY SH AH N
COMPLIMENT	K AA M P L AH M EH N T
COMPONENT	K AH M P OW N AH N T
COMPOSITION	K AA M P AH Z IH SH AH N
COMPOUND	K AA M P AW N D
COMPOUND(2)	K AH M P AW N D
COMPREHENSION	K AA M P R IY HH EH N SH AH N
COMPRESSION	K AH M P R EH SH AH N
COMPRESSOR	K AH M P R EH S ER
COMPROMISE	K AA M P R AH M AY Z
COMPUTER	K AH M P Y UW T ER
CON	K AA N
CONCENTRATION	K AA N S AH N T R EY SH AH N
CONCEPT	K AA N S EH P T
CONCERN	K AH N S ER N
CONCERT	K AA N S ER T
CONCERT(2)	K AH N S ER T
CONCLUSION	K AH N K L UW ZH AH N
CONCRETE	K AH N K R IY T
CONCRETE(2)	K AA N K R IY T
CONDEMNATION	K AA N D AH M N EY SH AH N
CONDIMENT	K AA N D AH M AH N T
CONDITION	K AH N D IH SH AH N
CONDITIONER	K AH N D IH SH AH N ER
CONDITIONING	K AH N D IH SH AH N IH NG
CONDO	K AA N D OW
CONDOMINIUM	K AA N D AH M IH N IY AH M
CONDUCT	K AA N D AH K T
CONDUIT	K AA N D UW IH T
CONDUIT(2)	K AA N JH UW IH T
CONDUIT(3)	K AA N D W IH T
CONFERENCE	K AA N F ER AH N S
CONFERENCE(2)	K AA N F R AH N S
CONFESSION	K AH N F EH SH AH N
CONFIDANTE	K AA N F AH D AE N T
CONFIDENCE	K AA N F AH D EH N S
CONFIDENTIALITY	K AA N F AH D EH N SH IY AE L AH T IY
CONFINES	K AA N F AY N Z
CONFINES(2)	K AH N F AY N Z
CONFIRM	K AH N F ER M
CONFIRMATION	K AA N F ER M EY SH AH N
CONFISCATION	K AA N F AH S K EY SH AH N
CONFLAGRATION	K AA N F L AH G R EY SH AH N
CONFLICT	K AA N F L IH K T
CONFLICT(2)	K AH N F L IH K T
CONFLUENCE	K AA N F L UW AH N S
CONFORMITY	K AH N F AO R M AH T IY
CONFRONTATION	K AA N F R AH N T EY SH AH N
CONFUSION	K AH N F Y UW ZH AH N
CONGLOMERATE	K AH N G L AA M ER AH T
CONGRATULATION	K AH N G R AE CH AH L EY SH AH N
CONGREGATION	K AA NG G R AH G EY SH AH N
CONGRESS	K AA NG G R AH S
CONJUNCTION	K AH N JH AH NG K SH AH N
CONNECTION	K AH N EH K SH AH N
CONNOISSEUR	K AA N AH S ER
CONQUEST	K AA NG K W EH S T
CONSCIENCE	K AA N SH AH N S
CONSCIOUSNESS	K AA N SH AH S N AH S
CONSENSUS	K AH N S EH N S AH S
CONSENT	K AH N S EH N T
CONSEQUENCE	K AA N S AH K W AH N S
CONSERVATION	K AA N S ER V EY SH AH N
CONSERVATIONIST	K AA N S ER V EY SH AH N IH S T
CONSERVATIVE	K AH N S ER V AH T IH V
CONSIDERATION	K AH N S IH D ER EY SH AH N
CONSISTENCY	K AH N S IH S T AH N S IY
CONSOLE	K AA N S OW L
CONSOLE(2)	K AH N S OW L
CONSOLIDATION	K AH N S AA L AH D EY SH AH N
CONSORTIUM	K AH N S AO R SH IY AH M
CONSORTIUM(2)	K AH N S AO R SH Y AH M
CONSPIRACY	K AH N S P IH R AH S IY
CONSPIRATOR	K AH N S P IH R AH T ER
CONSTITUTION	K AA N S T AH T UW SH AH N
CONSTRAINT	K AH N S T R EY N T
CONSTRUCTION	K AH N S T R AH K SH AH N
CONSULATE	K AA N S AH L AH T
CONSULTANT	K AH N S AH L T AH N T
CONSULTING	K AH N S AH L T IH NG
CONSUMER	K AH N S UW M ER
CONSUMPTION	K AH N S AH M P SH AH N
CONSUMPTION(2)	K AH N S AH M SH AH N
CONTACT	K AA N T AE K T
CONTAINER	K AH N T EY N ER
CONTEMPORARY	K AH N T EH M P ER EH R IY
CONTENDER	K AH N T EH N D ER
CONTENT	K AA N T EH N T
CONTENT(2)	K AH N T EH N T
CONTENTS	K AA N T EH N T S
CONTENTS(2)	K AH N T EH N T S
CONTEST	K AA N T EH S T
CONTEST(2)	K AH N T EH S T
CONTEXT	K AA N T EH K S T
CONTINENT	K AA N T AH N AH N T
CONTINGENCY	K AH N T IH N JH AH N S IY
CONTRACT	K AA N T R AE K T
CONTRACT(2)	K AH N T R AE K T
CONTRACTING	K AA N T R AE K T IH NG
CONTRACTION	K AH N T R AE K SH AH N
CONTRACTOR	K AA N T R AE K T ER
CONTRAST	K AA N T R AE S T
CONTRAST(2)	K AH N T R AE S T
CONTRIBUTION	K AA N T R AH B Y UW SH AH N
CONTRIBUTOR	K AH N T R IH B Y AH T ER
CONTROL	K AH N T R OW L
CONTROLLER	K AH N T R OW L ER
CONTROLS	K AH N T R OW L Z
CONTROVERSY	K AA N T R AH V ER S IY
CONUNDRUM	K AH N AH N D R AH M
CONVENIENCE	K AH N V IY N Y AH N S
CONVENTION	K AH N V EH N SH AH N
CONVERSATION	K AA N V ER S EY SH AH N
CONVERTER	K AH N V ER T ER
CONVEYOR	K AH N V EY ER
CONVICT	K AA N V IH K T
CONVICT(2)	K AH N V IH K T
CONVICTION	K AH N V IH K SH AH N
CONVOY	K AA N V OY
COOKBOOK	K UH K B UH K
COOKIE	K UH K IY
COOKING	K UH K IH NG
COOP	K UW P
COOPERATION	K OW AA P ER EY SH AH N
COOPERATION(2)	K W AA P ER EY SH AH N
COOPERATION(3)	K W AO P ER EY SH AH N
COORDINATION	K OW AO R D AH N EY SH AH N
COORDINATOR	K OW AO R D AH N EY T ER
COP	K AA P
COPY	K AA P IY
COPYING	K AA P IY IH NG
COPYRIGHT	K AA P IY R AY T
CORD	K AO R D
CORE	K AO R
CORK	K AO R K
CORKING	K AO R K IH NG
CORN	K AO R N
CORNER	K AO R N ER
CORPORATION	K AO R P ER EY SH AH N
CORPS	K AO R
CORPS(2)	K AO R Z
CORRECTION	K ER EH K SH AH N
CORRELATION	K AO R AH L EY SH AH N
CORRESPONDENCE	K AO R AH S P AA N D AH N S
CORRESPONDENT	K AO R AH S P AA N D AH N T
COSMOS	K AA Z M OW S
COST	K AA S T
COST(2)	K AO S T
COSTUME	K AA S T UW M
COTTON	K AA T AH N
COTTON(2)	K AO T AH N
COTTONWOOD	K AA T AH N W UH D
COUCH	K AW CH
COUNCIL	K AW N S AH L
COUNSEL	K AW N S AH L
COUNSELING	K AW N S AH L IH NG
COUNSELOR	K AW N S AH L ER
COUNT	K AW N T
COUNTER	K AW N T ER
COUNTERINTELLIGENCE	K AW N T ER IH N T EH L IH JH AH N S
COUNTERINTELLIGENCE(2)	K AW N ER IH N T EH L IH JH AH N S
COUNTERWEIGHT	K AW N T ER W EY T
COUNTRY	K AH N T R IY
COUNTRYMAN	K AH N T R IY M AH N
COUNTRYSIDE	K AH N T R IY S AY D
COUNTY	K AW N T IY
COUNTY(2)	K AW N IY
COUP	K UW
COUPLE	K AH P AH L
COUPON	K UW P AO N
COUPON(2)	K Y UW P AO N
COURAGE	K ER IH JH
COURSE	K AO R S
COURT	K AO R T
COURTESY	K ER T AH S IY
COUSIN	K AH Z AH N
COVER	K AH V ER
COVERAGE	K AH V ER AH JH
COVERAGE(2)	K AH V ER IH JH
COVERAGE(3)	K AH V R IH JH
COW	K AW
COWBOY	K AW B OY
COWORKER	K OW W ER K ER
CRAB	K R AE B
CRACK	K R AE K
CRACKDOWN	K R AE K D AW N
CRACKER	K R AE K ER
CRACKPOT	K R AE K P AA T
CRAFT	K R AE F T
CRAP	K R AE P
CRASH	K R AE SH
CRATE	K R EY T
CRAVING	K R EY V IH NG
CRAWFISH	K R AO F IH SH
CREATION	K R IY EY SH AH N
CREATIVITY	K R IY EY T IH V AH T IY
CREATURE	K R IY CH ER
CREDENCE	K R IY D AH N S
CREDIBILITY	K R EH D AH B IH L IH T IY
CREDIT	K R EH D AH T
CREDIT(2)	K R EH D IH T
CREDITOR	K R EH D AH T ER
CREDITOR(2)	K R EH D IH T ER
CREPE	K R EY P
CREST	K R EH S T
CRETIN	K R IY T AH N
CREW	K R UW
CRICKET	K R IH K IH T
CRIME	K R AY M
CRIMINAL	K R IH M AH N AH L
CRISIS	K R AY S AH S
CRITERIA	K R AY T IH R IY AH
CRITERION	K R AY T IH R IY AH N
CRITIC	K R IH T IH K
CRITICISM	K R IH T IH S IH Z AH M
CRITTER	K R IH T ER
CROISSANT	K W AA S AA N T
CROISSANT(2)	K R AH S AA N T
CROOK	K R UH K
CROP	K R AA P
CROSS	K R AO S
CROSSING	K R AO S IH NG
CROWD	K R AW D
CROWN	K R AW N
CRUCIBLE	K R UW S AH B AH L
CRUDE	K R UW D
CRUELTY	K R UW L T IY
CRUELTY(2)	K R UW AH L T IY
CRUISE	K R UW Z
CRUSADER	K R UW S EY D ER
CRUST	K R AH S T
CRUSTACEAN	K R AH S T EY SH AH N
CRY	K R AY
CUBE	K Y UW B
CUCKOO	K AH K UW
CUCKOO(2)	K UW K UW
CUCUMBER	K Y UW K AH M B ER
CUE	K Y UW
CUISINE	K W IH Z IY N
CULPRIT	K AH L P R IH T
CULT	K AH L T
CULTURE	K AH L CH ER
CUP	K AH P
CURATE	K Y UH R AH T
CURB	K ER B
CURE	K Y UH R
CURFEW	K ER F Y UW
CURRENCY	K ER AH N S IY
CURRENT	K ER AH N T
CURRENT(2)	K ER N T
CURRENT(3)	K AA R AH N T
CURSE	K ER S
CURSOR	K ER S ER
CURTAIN	K ER T AH N
CURVE	K ER V
CUSSING	K AH S IH NG
CUSTODY	K AH S T AH D IY
CUSTOM	K AH S T AH M
CUSTOMER	K AH S T AH M ER
CUT	K AH T
CUTICLE	K Y UW T AH K AH L
CUTICLE(2)	K Y UW T IH K AH L
CUTLERY	K AH T L ER IY
CUTTER	K AH T ER
CUTTING	K AH T IH NG
CYANIDE	S AY AH N AY D
CYANIDE(2)	S AY N AY D
CYCLE	S AY K AH L
CYCLING	S AY K AH L IH NG
CYCLING(2)	S AY K L IH NG
CYLINDER	S IH L AH N D ER
CYLINDER(2)	S IH L IH N D ER
DAD	D AE D
DADDY	D AE D IY
DAILY	D EY L IY
DAISY	D EY Z IY
DALE	D EY L
DAMAGE	D AE M AH JH
DAMAGE(2)	D AE M IH JH
DAMN	D AE M
DANCE	D AE N S
DANCER	D AE N S ER
DANCING	D AE N S IH NG
DANDELION	D AE N D AH L AY AH N
DANDY	D AE N D IY
DANGER	D EY N JH ER
DARK	D AA R K
DARKNESS	D AA R K N AH S
DARKROOM	D AA R K R UW M
DARN	D AA R N
DATA	D EY T AH
DATA(2)	D AE T AH
DATABASE	D EY T AH B EY S
DATABASE(2)	D AE T AH B EY S
DATE	D EY T
DATING	D EY T IH NG
DAUGHTER	D AO T ER
DAY	D EY
DAYTIME	D EY T AY M
DEACON	D IY K AH N
DEADLINE	D EH D L AY N
DEAL	D IY L
DEALER	D IY L ER
DEALERSHIP	D IY L ER SH IH P
DEAN	D IY N
DEAR	D IH R
DEATH	D EH TH
DEBATE	D AH B EY T
DEBIT	D EH B IH T
DEBRIS	D AH B R IY
DEBT	D EH T
DEBTOR	D EH T ER
DECADE	D EH K EY D
DECIDED	D IH S AY D IH D
DECISION	D IH S IH ZH AH N
DECK	D EH K
DECKING	D EH K IH NG
DECLARATION	D EH K L ER EY SH AH N
DECLINE	D IH K L AY N
DECOR	D IH K AO R
DECOR(2)	D EY K AO R
DECREASE	D IH K R IY S
DECREASE(2)	D IY K R IY S
DEDICATION	D EH D AH K EY SH AH N
DEED	D IY D
DEER	D IH R
DEFAMATION	D EH F AH M EY SH AH N
DEFAULT	D IH F AO L T
DEFEAT	D IH F IY T
DEFECT	D IY F EH K T
DEFECT(2)	D IH F EH K T
DEFENDANT	D IH F EH N D AH N T
DEFENSE	D IH F EH N S
DEFICIENCY	D IH F IH SH AH N S IY
DEFICIT	D EH F AH S AH T
DEFINITION	D EH F AH N IH SH AH N
DEGENERATE	D IH JH EH N ER AH T
DEGENERATE(2)	D IH JH EH N ER EY T
DEGREE	D IH G R IY
DELAY	D IH L EY
DELEGATE	D EH L AH G EY T
DELEGATE(2)	D EH L AH G AH T
DELEGATION	D EH L AH G EY SH AH N
DELI	D EH L IY
DELICACY	D EH L AH K AH S IY
DELICACY(2)	D EH L IH K AH S IY
DELICIOUSNESS	D IH L IH SH AH S N AH S
DELIGHT	D IH L AY T
DELIVERY	D IH L IH V ER IY
DELTA	D EH L T AH
DEMAND	D IH M AE N D
DEMISE	D IH M AY Z
DEMOCRACY	D IH M AA K R AH S IY
DEMOCRAT	D EH M AH K R AE T
DEMON	D IY M AH N
DEMONSTRATION	D EH M AH N S T R EY SH AH N
DEMOTION	D IH M OW SH AH N
DENIAL	D IH N AY AH L
DENTIST	D EH N T AH S T
DENTIST(2)	D EH N T IH S T
DENUNCIATION	D IH N AH N S IY EY SH AH N
DEPARTMENT	D IH P AA R T M AH N T
DEPARTURE	D IH P AA R CH ER
DEPENDENCY	D IH P EH N D AH N S IY
DEPICTION	D IH P IH K SH AH N
DEPLOYMENT	D IH P L OY M AH N T
DEPOSIT	D AH P AA Z IH T
DEPOSIT(2)	D IH P AA Z AH T
DEPOSITION	D EH P AH Z IH SH AH N
DEPOT	D IY P OW
DEPTH	D EH P TH
DEPUTY	D EH P Y AH T IY
DEPUTY(2)	D EH P Y UW T IY
DERAILING	D IH R EY L IH NG
DEREGULATION	D IY R EH G Y AH L EY SH AH N
DERIVATIVE	D ER IH V AH T IH V
DERIVATIVE(2)	D ER IH V IH T IH V
DESCENDANT	D IH S EH N D AH N T
DESCRIPTION	D IH S K R IH P SH AH N
DESIGN	D IH Z AY N
DESIGNER	D IH Z AY N ER
DESIRE	D IH Z AY ER
DESK	D EH S K
DESPAIR	D IH S P EH R
DESPERATION	D EH S P ER EY SH AH N
DESPERATION(2)	D EH S P ER EY SH IH N
DESPOTISM	D EH S P AH T IH Z AH M
DESSERT	D IH Z ER T
DESTINATION	D EH S T AH N EY SH AH N
DESTINATION(2)	D EH S T IH N EY SH AH N
DESTINY	D EH S T AH N IY
DESTROYER	D IH S T R OY ER
DESTRUCTION	D IH S T R AH K SH AH N
DETAIL	D IH T EY L
DETAIL(2)	D IY T EY L
DETECTION	D IH T EH K SH AH N
DETECTIVE	D IH T EH K T IH V
DETECTOR	D IH T EH K T ER
DETENTION	D IH T EH N SH AH N
DETERIORATION	D IH T IH R IY ER EY SH AH N
DETERMINATION	D IH T ER M AH N EY SH AH N
DETERMINER	D IY T ER M AH N ER
DETRACTOR	D IY T R AE K T ER
DEVELOPER	D IH V EH L AH P ER
DEVELOPMENT	D IH V EH L AH P M AH N T
DEVIATION	D IY V IY EY SH AH N
DEVICE	D IH V AY S
DEVIL	D EH V AH L
DIAPER	D AY P ER
DIARRHEA	D AY ER IY AH
DICTATOR	D IH K T EY T ER
DICTATORSHIP	D IH K T EY T ER SH IH P
DICTIONARY	D IH K SH AH N EH R IY
DIET	D AY AH T
DIFFERENCE	D IH F ER AH N S
DIFFERENCE(2)	D IH F R AH N S
DIFFERENT	D IH F ER AH N T
DIFFERENT(2)	D IH F R AH N T
DIFFERENTIAL	D IH F ER EH N SH AH L
DIFFICULTY	D IH F AH K AH L T IY
DIFFICULTY(2)	D IH F IH K AH L T IY
DIGNITARY	D IH G N AH T EH R IY
DILEMMA	D IH L EH M AH
DILIGENCE	D IH L IH JH AH N S
DIME	D AY M
DINER	D AY N ER
DING	D IH NG
DINING	D AY N IH NG
DINNER	D IH N ER
DIOXIDE	D AY AA K S AY D
DIP	D IH P
DIPLOMACY	D IH P L OW M AH S IY
DIPLOMAT	D IH P L AH M AE T
DIRECTION	D ER EH K SH AH N
DIRECTION(2)	D IY R EH K SH IH N
DIRECTION(3)	D AY R EH K SH IH N
DIRECTION(4)	D IH R EH K SH IH N
DIRECTIVE	D ER EH K T IH V
DIRECTIVE(2)	D IY R EH K T IH V
DIRECTIVE(3)	D AY R EH K T IH V
DIRECTIVE(4)	D IH R EH K T IH V
DIRECTOR	D ER EH K T ER
DIRECTOR(2)	D AY R EH K T ER
DIRECTOR(3)	D IY R EH K T ER
DIRECTOR(4)	D IH R EH K T ER
DIRT	D ER T
DISABILITY	D IH S AH B IH L IH T IY
DISABILITY(2)	D IH S AH B IH L IH T IY Z
DISAPPEARANCE	D IH S AH P IH R AH N S
DISAPPEARANCE(2)	D IH S AH P IY R AH N S
DISAPPOINTMENT	D IH S AH P OY N T M AH N T
DISARMING	D IH S AA R M IH NG
DISASTER	D IH Z AE S T ER
DISC	D IH S K
DISCHARGE	D IH S CH AA R JH
DISCIPLINE	D IH S AH P L AH N
DISCLAIMER	D IH S K L EY M ER
DISCLOSURE	D IH S K L OW ZH ER
DISCO	D IH S K OW
DISCOMFORT	D IH S K AH M F ER T
DISCONTENT	D IH S K AH N T EH N T
DISCOUNT	D IH S K AW N T
DISCOVERY	D IH S K AH V ER IY
DISCOVERY(2)	D IH S K AH V R IY
DISCREDITING	D IH S K R EH D AH T IH NG
DISCREPANCY	D IH S K R EH P AH N S IY
DISCRETION	D IH S K R EH SH AH N
DISCRIMINATION	D IH S K R IH M AH N EY SH AH N
DISCUSSION	D IH S K AH SH AH N
DISEASE	D IH Z IY Z
DISGRACE	D IH S G R EY S
DISH	D IH SH
DISINFORMATION	D IH Z IH N F ER M EY SH AH N
DISINTEGRATION	D IH S IH N T AH G R EY SH AH N
DISINTEGRATION(2)	D IH S IH N AH G R EY SH AH N
DISK	D IH S K
DISLIKE	D IH S L AY K
DISMAY	D IH S M EY
DISPATCH	D IH S P AE CH
DISPERSAL	D IH S P ER S AH L
DISPLAY	D IH S P L EY
DISPOSAL	D IH S P OW Z AH L
DISPUTE	D IH S P Y UW T
DISREGARD	D IH S R IH G AA R D
DISREPAIR	D IH S R IH P EH R
DISRUPTION	D IH S R AH P SH AH N
DISSATISFACTION	D IH S AE T IH S F AE K SH AH N
DISSEMINATION	D IH S EH M AH N EY SH AH N
DISSIPATION	D IH S IH P EY SH AH N
DISTANCE	D IH S T AH N S
DISTINCTION	D IH S T IH NG K SH AH N
DISTRESS	D IH S T R EH S
DISTRIBUTION	D IH S T R AH B Y UW SH AH N
DISTRICT	D IH S T R IH K T
DIVERSIFICATION	D AY V ER S AH F AH K EY SH AH N
DIVERSIFICATION(2)	D IH V ER S AH F AH K EY SH AH N
DIVERSION	D AY V ER ZH AH N
DIVERSION(2)	D IH V ER ZH AH N
DIVERSITY	D IH V ER S IH T IY
DIVERSITY(2)	D AY V ER S IH T IY
DIVIDEND	D IH V IH D EH N D
DIVING	D AY V IH NG
DIVINITY	D IH V IH N AH T IY
DIVISION	D IH V IH ZH AH N
DIVORCE	D IH V AO R S
DOC	D AA K
DOCK	D AA K
DOCKING	D AA K IH NG
DOCTOR	D AA K T ER
DOCTOR(2)	D AO K T ER
DOCUMENT	D AA K Y AH M EH N T
DOCUMENT(2)	D AA K Y UW M EH N T
DOCUMENTATION	D AA K Y AH M EH N T EY SH AH N
DOCUMENTATION(2)	D AA K Y UW M EH N T EY SH AH N
DOER	D UW R
DOG	D AO G
DOGS	D AA G Z
DOGS(2)	D AO G Z
DOGWOOD	D AO G W UH D
DOLLAR	D AA L ER
DOLLAR(2)	D AO L ER
DOMAIN	D OW M EY N
DOMESTIC	D AH M EH S T IH K
DOMINANCE	D AA M AH N AH N S
DONATION	D OW N EY SH AH N
DONOR	D OW N ER
DOOR	D AO R
DOORSTEP	D AO R S T EH P
DOPE	D OW P
DOT	D AA T
DOUBLE	D AH B AH L
DOUBT	D AW T
DOUGH	D OW
DOVE	D AH V
DOVE(2)	D OW V
DOWN	D AW N
DOWNFALL	D AW N F AO L
DOWNLOAD	D AW N L OW D
DOWNLOADING	D AW N L OW D IH NG
DOWNS	D AW N Z
DOWNSIZING	D AW N S AY Z IH NG
DOWNTOWN	D AW N T AW N
DOZEN	D AH Z AH N
DRAFT	D R AE F T
DRAG	D R AE G
DRAGON	D R AE G AH N
DRAMA	D R AA M AH
DRAW	D R AO
DRAWER	D R AO R
DRAWING	D R AO IH NG
DREAM	D R IY M
DREGS	D R EH G Z
DRESS	D R EH S
DRESSAGE	D R EH S AA ZH
DRESSER	D R EH S ER
DRIFTWOOD	D R IH F T W UH D
DRILL	D R IH L
DRILLING	D R IH L IH NG
DRINK	D R IH NG K
DRINKING	D R IH NG K IH NG
DRIP	D R IH P
DRIVE	D R AY V
DRIVER	D R AY V ER
DRIVEWAY	D R AY V W EY
DRIVING	D R AY V IH NG
DROP	D R AA P
DROP(2)	D R AO P
DRUG	D R AH G
DRY	D R AY
DRYER	D R AY ER
DRYING	D R AY IH NG
DUALITY	D UW AE L AH T IY
DUCK	D AH K
DUCT	D AH K T
DUDE	D UW D
DUPLICITY	D UW P L IH S IH T IY
DURABILITY	D ER AH B IH L IH T IY
DURATION	D UH R EY SH AH N
DURESS	D UH R EH S
DUST	D AH S T
DUSTER	D AH S T ER
DUSTING	D AH S T IH NG
DUTY	D UW T IY
DUTY(2)	D Y UW T IY
DWARF	D W AO R F
DWELLER	D W EH L ER
DYNAMIC	D AY N AE M IH K
DYNAMICS	D AY N AE M IH K S
DYSENTERY	D IH S AH N T EH R IY
DYSPEPSIA	D IH S EH P S IY AH
EAGLE	IY G AH L
EAR	IY R
EAR(2)	IH R
EARMUFF	IH R M AH F
EARMUFF(2)	IY R M AH F
EARNING	ER N IH NG
EARRING	IH R IH NG
EARRING(2)	IY R IH NG
EARTH	ER TH
EARTHQUAKE	ER TH K W EY K
EARTHWORM	ER TH W ER M
EASE	IY Z
EAST	IY S T
EAT	IY T
EATABLES	IY T AH B AH L Z
EATER	IY T ER
EATING	IY T IH NG
ECLIPSE	IH K L IH P S
ECLIPSE(2)	AH K L IH P S
ECLIPSE(3)	IY K L IH P S
ECOLOGIST	IH K AA L AH JH IH S T
ECOLOGIST(2)	IY K AA L AH JH IH S T
ECOLOGY	IH K AA L AH JH IY
ECOLOGY(2)	IY K AA L AH JH IY
ECONOMICS	EH K AH N AA M IH K S
ECONOMICS(2)	IY K AH N AA M IH K S
ECONOMIST	IH K AA N AH M IH S T
ECONOMIST(2)	IY K AA N AH M IH S T
ECONOMY	IH K AA N AH M IY
ECONOMY(2)	IY K AA N AH M IY
ECOSYSTEM	IY K OW S IH S T AH M
EDGE	EH JH
EDIT	EH D AH T
EDITING	EH D AH T IH NG
EDITING(2)	EH D IH T IH NG
EDITOR	EH D AH T ER
EDITOR(2)	EH D IH T ER
EDITORIAL	EH D AH T AO R IY AH L
EDUCATION	EH JH AH K EY SH AH N
EDUCATION(2)	EH JH Y UW K EY SH AH N
EDUCATOR	EH JH AH K EY T ER
EDUCATOR(2)	EH JH Y UW K EY T ER
EFFECT	IH F EH K T
EFFECT(2)	IY F EH K T
EFFECT(3)	AH F EH K T
EFFECTIVENESS	IH F EH K T IH V N AH S
EFFECTIVENESS(2)	IY F EH K T IH V N AH S
EFFICIENCY	IH F IH SH AH N S IY
EFFORT	EH F ER T
EGG	EH G
EGO	IY G OW
EIGHTY	EY T IY
ELDER	EH L D ER
ELECTION	IH L EH K SH AH N
ELECTRIC	IH L EH K T R IH K
ELECTRICITY	IH L EH K T R IH S AH T IY
ELECTROLYTE	AH L EH K T R AH L AY T
ELECTRONICS	IH L EH K T R AA N IH K S
ELEMENT	EH L AH M AH N T
ELEPHANT	EH L AH F AH N T
ELEVATOR	EH L AH V EY T ER
ELIGIBILITY	EH L IH JH AH B IH L IH T IY
ELK	EH L K
EMAIL	IY M EY L
EMBARRASSMENT	IH M B EH R AH S M AH N T
EMBASSY	EH M B AH S IY
EMBRACE	EH M B R EY S
EMBRACE(2)	IH M B R EY S
EMBRYO	EH M B R IY OW
EMERGENCY	IH M ER JH AH N S IY
EMERGENCY(2)	IY M ER JH AH N S IY
EMIRATE	EH M ER AH T
EMIRATE(2)	EH M ER EY T
EMISSION	IH M IH SH AH N
EMOTION	IH M OW SH AH N
EMOTION(2)	IY M OW SH AH N
EMPATHY	EH M P AH TH IY
EMPEROR	EH M P ER ER
EMPLOYEE	EH M P L OY IY
EMPLOYEE(2)	IH M P L OY IY
EMPLOYER	EH M P L OY ER
EMPLOYER(2)	IH M P L OY ER
EMPLOYMENT	EH M P L OY M AH N T
EMPLOYMENT(2)	IH M P L OY M AH N T
EMPOWERMENT	IH M P AW ER M AH N T
EMPTINESS	EH M P T IY N AH S
EMPTINESS(2)	EH M T IY N AH S
ENCHILADA	EH N CH IH L AA D AH
ENCHILADAS	IH N CH IH L AH D AH Z
ENCLOSURE	EH N K L OW ZH ER
ENCLOSURE(2)	IH N K L OW ZH ER
ENCOUNTER	IH N K AW N T ER
ENCOUNTER(2)	IH N K AW N ER
ENCOURAGEMENT	EH N K ER IH JH M AH N T
END	EH N D
ENDANGERED	EH N D EY N JH ER D
ENDANGERED(2)	IH N D EY N JH ER D
ENDEAVOR	IH N D EH V ER
ENDORSEMENT	EH N D AO R S M AH N T
ENEMY	EH N AH M IY
ENERGY	EH N ER JH IY
ENFORCEMENT	EH N F AO R S M AH N T
ENGAGEMENT	EH N G EY JH M AH N T
ENGINE	EH N JH AH N
ENGINE(2)	IH N JH AH N
ENGINEER	EH N JH AH N IH R
ENGINEERING	EH N JH AH N IH R IH NG
ENJOYMENT	EH N JH OY M AH N T
ENLIGHTENMENT	EH N L AY T AH N M AH N T
ENQUIRY	IH N K W AY R IY
ENSEMBLE	AA N S AA M B AH L
ENTERED	EH N T ER D
ENTERED(2)	EH N ER D
ENTERING	EH N T ER IH NG
ENTERING(2)	EH N ER IH NG
ENTERPRISE	EH N T ER P R AY Z
ENTERPRISE(2)	EH N ER P R AY Z
ENTERTAINMENT	EH N T ER T EY N M AH N T
ENTERTAINMENT(2)	EH N ER T EY N M AH N T
ENTHUSIASM	IH N TH UW Z IY AE Z AH M
ENTIRE	IH N T AY ER
ENTITY	EH N T AH T IY
ENTITY(2)	EH N T IH T IY
ENTOURAGE	AA N T UH R AA ZH
ENTOURAGE(2)	AA N T ER AA ZH
ENTRANCE	EH N T R AH N S
ENTREATY	EH N T R IY T IY
ENTRÃ©E	IH N T AH R
ENTRY	EH N T R IY
ENVELOPE	EH N V AH L OW P
ENVIRONMENT	IH N V AY R AH N M AH N T
ENVIRONMENTALIST	IH N V AY R AH N M EH N T AH L IH S T
ENVIRONMENTALIST(2)	IH N V AY R AH N M EH N AH L IH S T
ENVOY	EH N V OY
ENVOY(2)	AA N V OY
ENVY	EH N V IY
EPISODE	EH P IH S OW D
EPITHET	EH P AH TH EH T
EPITOME	IH P IH T AH M IY
EQUALITY	IH K W AA L AH T IY
EQUATION	IH K W EY ZH AH N
EQUIPMENT	IH K W IH P M AH N T
EQUITY	EH K W AH T IY
ERA	EH R AH
ERA(2)	IH R AH
EROSION	IH R OW ZH AH N
ERROR	EH R ER
ESCALATION	EH S K AH L EY SH AH N
ESCALATOR	EH S K AH L EY T ER
ESCAPE	IH S K EY P
ESSENCE	EH S AH N S
ESTABLISHMENT	IH S T AE B L IH SH M AH N T
ESTIMATE	EH S T AH M AH T
ESTIMATE(2)	EH S T AH M EY T
ETA	EY T AH
ETHIC	EH TH IH K
ETHNICITY	EH TH N IH S IH T IY
ETIQUETTE	EH T AH K AH T
EVACUEE	IH V AE K Y UW IY
EVACUEE(2)	IY V AE K Y UW IY
EVALUATION	IH V AE L Y UW EY SH AH N
EVALUATION(2)	IY V AE L Y UW EY SH AH N
EVENING	IY V N IH NG
EVENT	IH V EH N T
EVENT(2)	IY V EH N T
EVERYDAY	EH V R IY D EY
EVIDENCE	EH V AH D AH N S
EVIL	IY V AH L
EVOLUTION	EH V AH L UW SH AH N
EVOLUTION(2)	IY V AH L UW SH AH N
EVOLUTION(3)	EH V OW L UW SH AH N
EVOLUTION(4)	IY V OW L UW SH AH N
EXAM	IH G Z AE M
EXAMINATION	IH G Z AE M AH N EY SH AH N
EXAMPLE	IH G Z AE M P AH L
EXCELLENCE	EH K S AH L AH N S
EXCEPTION	IH K S EH P SH AH N
EXCERPT	EH K S ER P T
EXCHANGE	IH K S CH EY N JH
EXCLUSION	IH K S K L UW ZH AH N
EXCUSE	IH K S K Y UW S
EXCUSE(2)	IH K S K Y UW Z
EXECUTION	EH K S AH K Y UW SH AH N
EXECUTIVE	IH G Z EH K Y AH T IH V
EXERCISE	EH K S ER S AY Z
EXHAUST	IH G Z AO S T
EXHAUSTION	IH G Z AO S CH AH N
EXHIBIT	IH G Z IH B IH T
EXHIBITION	EH K S AH B IH SH AH N
EXISTENCE	EH G Z IH S T AH N S
EXISTENCE(2)	IH G Z IH S T AH N S
EXIT	EH G Z IH T
EXIT(2)	EH K S AH T
EXPANSION	IH K S P AE N SH AH N
EXPANSION(2)	IH K S P AE N CH AH N
EXPECTANCY	IH K S P EH K T AH N S IY
EXPECTATION	EH K S P EH K T EY SH AH N
EXPENSE	IH K S P EH N S
EXPERIENCE	IH K S P IH R IY AH N S
EXPERT	EH K S P ER T
EXPERTISE	EH K S P ER T IY Z
EXPIRATION	EH K S P ER EY SH AH N
EXPLANATION	EH K S P L AH N EY SH AH N
EXPLORATION	EH K S P L ER EY SH AH N
EXPLORATION(2)	EH K S P L AO R EY SH AH N
EXPLORER	IH K S P L AO R ER
EXPLORING	IH K S P L AO R IH NG
EXPLOSIVE	IH K S P L OW S IH V
EXPORTER	IH K S P AO R T ER
EXPOSITION	EH K S P AH Z IH SH AH N
EXPOSURE	IH K S P OW ZH ER
EXPRESSION	IH K S P R EH SH AH N
EXPRESSIONIST	IH K S P R EH SH AH N AH S T
EXPULSION	IH K S P AH L SH AH N
EXTENSION	IH K S T EH N SH AH N
EXTENT	IH K S T EH N T
EXTERMINATION	IH K S T ER M AH N EY SH AH N
EXTERMINATOR	IH K S T ER M AH N EY T ER
EXTINCTION	IH K S T IH NG K SH AH N
EXTINCTION(2)	IH K S T IH NG SH AH N
EXTRA	EH K S T R AH
EXTRACT	EH K S T R AE K T
EXTRACT(2)	IH K S T R AE K T
EXTRACTION	EH K S T R AE K SH AH N
EXTRADITION	EH K S T R AH D IH SH AH N
EXTREMIST	IH K S T R IY M IH S T
EYE	AY
EYELID	AY L IH D
EYEWITNESS	AY W IH T N AH S
FABRIC	F AE B R IH K
FABRICATION	F AE B R IH K EY SH AH N
FACE	F EY S
FACILITY	F AH S IH L IH T IY
FACT	F AE K T
FACTION	F AE K SH AH N
FACTOR	F AE K T ER
FACTORY	F AE K T ER IY
FAILURE	F EY L Y ER
FAITH	F EY TH
FAKE	F EY K
FALL	F AO L
FALL(2)	F AA L
FALLIBILITY	F AE L IH B IH L IH T IY
FALLING	F AA L IH NG
FALLOUT	F AO L AW T
FALLS	F AO L Z
FALSEHOOD	F AE L S HH UH D
FAME	F EY M
FAMILIARITY	F AH M IH L Y EH R AH T IY
FAMILY	F AE M AH L IY
FAMILY(2)	F AE M L IY
FAN	F AE N
FANATICISM	F AH N AE T AH S IH Z AH M
FANCY	F AE N S IY
FANTASY	F AE N T AH S IY
FANTASY(2)	F AE N AH S IY
FARCE	F AA R S
FARE	F EH R
FARM	F AA R M
FARMER	F AA R M ER
FARMLAND	F AA R M L AE N D
FASHION	F AE SH AH N
FAT	F AE T
FATHER	F AA DH ER
FAULT	F AO L T
FAVOR	F EY V ER
FAVORITE	F EY V ER IH T
FAVORITE(2)	F EY V R AH T
FAX	F AE K S
FEAR	F IH R
FEAST	F IY S T
FEATHER	F EH DH ER
FEATURE	F IY CH ER
FEDERATION	F EH D ER EY SH AH N
FEE	F IY
FEED	F IY D
FEEDBACK	F IY D B AE K
FEEDER	F IY D ER
FEEDING	F IY D IH NG
FEEL	F IY L
FEELING	F IY L IH NG
FEET	F IY T
FELLOW	F EH L OW
FEMALE	F IY M EY L
FEMINISM	F EH M IH N IH Z AH M
FENCE	F EH N S
FERVOR	F ER V ER
FESTIVAL	F EH S T AH V AH L
FESTIVAL(2)	F EH S T IH V AH L
FESTIVITY	F EH S T IH V AH T IY
FETISHISM	F EH T IH SH IH Z AH M
FEVER	F IY V ER
FEW	F Y UW
FICTION	F IH K SH AH N
FIELD	F IY L D
FIFTEENTH	F IH F T IY N TH
FIGHT	F AY T
FIGHTER	F AY T ER
FIGHTING	F AY T IH NG
FIGURE	F IH G Y ER
FILE	F AY L
FILIGREE	F IH L AH G R IY
FILING	F AY L IH NG
FILLER	F IH L ER
FILM	F IH L M
FILMING	F IH L M IH NG
FILMMAKER	F IH L M EY K ER
FILTER	F IH L T ER
FIN	F IH N
FINANCE	F AH N AE N S
FINANCE(2)	F IH N AE N S
FINANCE(3)	F AY N AE N S
FINANCES	F IH N AE N S IH Z
FINANCES(2)	F AY N AE N S IH Z
FINANCIAL	F AH N AE N SH AH L
FINANCIAL(2)	F IH N AE N SH AH L
FINANCIAL(3)	F AY N AE N SH AH L
FINANCING	F AH N AE N S IH NG
FINANCING(2)	F IH N AE N S IH NG
FINANCING(3)	F AY N AE N S IH NG
FINCH	F IH N CH
FIND	F AY N D
FINDING	F AY N D IH NG
FINGER	F IH NG G ER
FINISH	F IH N IH SH
FIRE	F AY ER
FIRE(2)	F AY R
FIREPOWER	F AY R P AW ER
FIREWALL	F AY R W AA L
FIRM	F ER M
FIRST	F ER S T
FISH	F IH SH
FISHERY	F IH SH ER IY
FISHING	F IH SH IH NG
FIST	F IH S T
FIT	F IH T
FITNESS	F IH T N AH S
FITTER	F IH T ER
FIVES	F AY V Z
FIX	F IH K S
FIXATION	F IH K S EY SH AH N
FIXING	F IH K S IH NG
FIXTURE	F IH K S CH ER
FLAG	F L AE G
FLAKE	F L EY K
FLANK	F L AE NG K
FLASHLIGHT	F L AE SH L AY T
FLAT	F L AE T
FLATFISH	F L AE T F IH SH
FLAVOR	F L EY V ER
FLAW	F L AO
FLEA	F L IY
FLEECE	F L IY S
FLEEING	F L IY IH NG
FLEET	F L IY T
FLESH	F L EH SH
FLEXIBILITY	F L EH K S AH B IH L AH T IY
FLICKER	F L IH K ER
FLIER	F L AY ER
FLIGHT	F L AY T
FLIPPING	F L IH P IH NG
FLOATING	F L OW T IH NG
FLOCK	F L AA K
FLOOD	F L AH D
FLOODING	F L AH D IH NG
FLOOR	F L AO R
FLOORING	F L AO R IH NG
FLOPPING	F L AA P IH NG
FLORIST	F L AA R IH S T
FLORIST(2)	F L AO R IH S T
FLOW	F L OW
FLOWER	F L AW ER
FLUID	F L UW AH D
FLUID(2)	F L UW IH D
FLY	F L AY
FLYER	F L AY ER
FOCUS	F OW K AH S
FOCUS(2)	F OW K IH S
FOE	F OW
FOLD	F OW L D
FOLK	F OW K
FOLLOW	F AA L OW
FOLLOWER	F AA L OW ER
FOLLOWING	F AA L OW IH NG
FOLLY	F AA L IY
FOOD	F UW D
FOOL	F UW L
FOOT	F UH T
FOOTBALL	F UH T B AO L
FOOTWEAR	F UH T W EH R
FORCE	F AO R S
FOREARM	F AO R AA R M
FORECAST	F AO R K AE S T
FOREGROUND	F AO R G R AW N D
FOREIGNER	F AO R AH N ER
FOREIGNER(2)	F AA R AH N ER
FOREIGNER(3)	F AO R N ER
FOREIGNER(4)	F AA R N ER
FOREST	F AO R AH S T
FOREST(2)	F AO R IH S T
FORESTRY	F AO R AH S T R IY
FORGER	F AO R JH ER
FORGIVENESS	F ER G IH V N AH S
FORGIVENESS(2)	F AO R G IH V N AH S
FORM	F AO R M
FORMALITY	F AO R M AE L AH T IY
FORMAT	F AO R M AE T
FORMULA	F AO R M Y AH L AH
FORUM	F AO R AH M
FORWARDING	F AO R W ER D IH NG
FOSSIL	F AA S AH L
FOSTER	F AA S T ER
FOUNDATION	F AW N D EY SH AH N
FOUNDER	F AW N D ER
FOUNTAIN	F AW N T AH N
FOURTH	F AO R TH
FOX	F AA K S
FRACTION	F R AE K SH AH N
FRAGRANCE	F R EY G R AH N S
FRAME	F R EY M
FRANCHISE	F R AE N CH AY Z
FRAUD	F R AO D
FRAY	F R EY
FREEDOM	F R IY D AH M
FREEZE	F R IY Z
FREEZING	F R IY Z IH NG
FREIGHT	F R EY T
FREIGHTER	F R EY T ER
FREQUENCY	F R IY K W AH N S IY
FRESCO	F R EH S K OW
FRIDGE	F R IH JH
FRIEND	F R EH N D
FRIENDLINESS	F R EH N D L IY N IH S
FRIENDSHIP	F R EH N D SH IH P
FRIES	F R AY Z
FRITTER	F R IH T ER
FRONT	F R AH N T
FROST	F R AO S T
FROSTING	F R AO S T IH NG
FRUIT	F R UW T
FRUSTRATION	F R AH S T R EY SH AH N
FRY	F R AY
FUEL	F Y UW AH L
FUEL(2)	F Y UW L
FUGITIVE	F Y UW JH AH T IH V
FUGITIVE(2)	F Y UW JH IH T IH V
FUME	F Y UW M
FUN	F AH N
FUNCTION	F AH NG K SH AH N
FUNCTIONALITY	F AH NG K SH AH N AE L IH T IY
FUND	F AH N D
FUNDAMENTALIST	F AH N D AH M EH N T AH L IH S T
FUNDAMENTALIST(2)	F AH N D AH M EH N AH L IH S T
FUNDING	F AH N D IH NG
FUNERAL	F Y UW N ER AH L
FUNGUS	F AH NG G AH S
FUR	F ER
FURNACE	F ER N AH S
FURNISHINGS	F ER N IH SH IH NG Z
FURNITURE	F ER N IH CH ER
FUSE	F Y UW Z
FUSION	F Y UW ZH AH N
FUSS	F AH S
FUTURE	F Y UW CH ER
GAIN	G EY N
GALL	G AO L
GALLERY	G AE L ER IY
GALLON	G AE L AH N
GAMBIT	G AE M B IH T
GAMBLING	G AE M B AH L IH NG
GAMBLING(2)	G AE M B L IH NG
GAME	G EY M
GAMING	G EY M IH NG
GAMUT	G AE M AH T
GANG	G AE NG
GANGLAND	G AE NG L AE N D
GAP	G AE P
GAPS	G AE P S
GARAGE	G ER AA ZH
GARBAGE	G AA R B IH JH
GARDEN	G AA R D AH N
GARDENING	G AA R D AH N IH NG
GARDENING(2)	G AA R D N IH NG
GARLIC	G AA R L IH K
GARMENT	G AA R M AH N T
GARNISH	G AA R N IH SH
GARRISON	G AE R IH S AH N
GAS	G AE S
GASH	G AE SH
GASP	G AE S P
GATE	G EY T
GATHERING	G AE DH ER IH NG
GAY	G EY
GEAR	G IH R
GEARBOX	G IH R B AA K S
GEE	JH IY
GEL	JH EH L
GEM	JH EH M
GENDER	JH EH N D ER
GENE	JH IY N
GENEALOGY	JH IY N IY AA L AH JH IY
GENERAL	JH EH N ER AH L
GENERAL(2)	JH EH N R AH L
GENERALIZATION	JH EH N ER AH L IH Z EY SH AH N
GENERALIZATION(2)	JH EH N R AH L IH Z EY SH AH N
GENERATING	JH EH N ER EY T IH NG
GENERATION	JH EH N ER EY SH AH N
GENERATOR	JH EH N ER EY T ER
GENETICS	JH AH N EH T IH K S
GENITALS	JH EH N AH T AH L Z
GENIUS	JH IY N Y AH S
GENOCIDE	JH EH N AH S AY D
GENTLEMAN	JH EH N T AH L M AH N
GENTLEMAN(2)	JH EH N AH L M AH N
GEOPOLITICS	JH IY OW P AA L AH T IH K S
GERBIL	JH AH R B AH L
GESTURE	JH EH S CH ER
GIANT	JH AY AH N T
GIFT	G IH F T
GINGER	JH IH N JH ER
GIRAFFE	JH ER AE F
GIRL	G ER L
GIRLFRIEND	G ER L F R EH N D
GIVE	G IH V
GIVEN	G IH V AH N
GIVEN(2)	G IH V IH N
GLAND	G L AE N D
GLASS	G L AE S
GLITCH	G L IH CH
GLOB	G L AA B
GLOBE	G L OW B
GLOVE	G L AH V
GLOW	G L OW
GLUE	G L UW
GLUT	G L AH T
GOAL	G OW L
GOAT	G OW T
GOD	G AA D
GODDESS	G AA D AH S
GODSEND	G AA D S EH N D
GOLD	G OW L D
GOLDEN	G OW L D AH N
GOLF	G AA L F
GOLF(2)	G AO L F
GOLFER	G AA L F ER
GOOD	G UH D
GOOD(2)	G IH D
GOODNESS	G UH D N AH S
GOODNESS(2)	G UH D N IH S
GOODS	G UH D Z
GORSE	G AO R S
GOUGING	G AW JH IH NG
GOUT	G AW T
GOVERNMENT	G AH V ER N M AH N T
GOVERNOR	G AH V ER N ER
GOWN	G AW N
GRAD	G R AE D
GRADE	G R EY D
GRADUATE	G R AE JH AH W AH T
GRADUATE(2)	G R AE JH AH W EY T
GRADUATE(3)	G R AE JH UW W AH T
GRADUATE(4)	G R AE JH UW EY T
GRADUATION	G R AE JH UW EY SH AH N
GRADUATION(2)	G R AE JH AH W EY SH AH N
GRAIL	G R EY L
GRAIN	G R EY N
GRAM	G R AE M
GRANDCHILD	G R AE N D CH AY L D
GRANDCHILD(2)	G R AE N CH AY L D
GRANDDAUGHTER	G R AE N D AO T ER
GRANDEUR	G R AE N D UW R
GRANDFATHER	G R AE N D F AA DH ER
GRANDFATHER(2)	G R AE N F AA DH ER
GRANDMA	G R AE N D M AA
GRANDMOTHER	G R AE N D M AH DH ER
GRANDPARENT	G R AE N D P EH R AH N T
GRANDSON	G R AE N D S AH N
GRANT	G R AE N T
GRANTING	G R AE N T IH NG
GRANTING(2)	G R AE N IH NG
GRAPHIC	G R AE F IH K
GRASS	G R AE S
GRAVE	G R EY V
GRAVEL	G R AE V AH L
GRAVITY	G R AE V AH T IY
GRAVITY(2)	G R AE V IH T IY
GRAVY	G R EY V IY
GRAY	G R EY
GREASE	G R IY S
GREATNESS	G R EY T N AH S
GREED	G R IY D
GREEN	G R IY N
GREENHOUSE	G R IY N HH AW S
GREETING	G R IY T IH NG
GRENADE	G R AH N EY D
GREY	G R EY
GRID	G R IH D
GRILL	G R IH L
GRINDER	G R AY N D ER
GRINDSTONE	G R AY N D S T OW N
GRIP	G R IH P
GRIST	G R IH S T
GROCERY	G R OW S ER IY
GROCERY(2)	G R OW S R IY
GROSS	G R OW S
GROUND	G R AW N D
GROUNDS	G R AW N D Z
GROUNDS(2)	G R AW N Z
GROUP	G R UW P
GROWTH	G R OW TH
GUACAMOLE	G W AA K AH M OW L IY
GUARANTEE	G EH R AH N T IY
GUARANTY	G EH R AH N T IY
GUARD	G AA R D
GUARDIAN	G AA R D IY AH N
GUARDSMAN	G AA R D Z M AE N
GUARDSMAN(2)	G AA R D Z M AH N
GUERILLA	G ER IH L AH
GUERRILLA	G ER IH L AH
GUESS	G EH S
GUEST	G EH S T
GUIDANCE	G AY D AH N S
GUIDE	G AY D
GUIDELINE	G AY D L AY N
GUILD	G IH L D
GUILT	G IH L T
GUILTY	G IH L T IY
GUINEA	G IH N IY
GUITAR	G IH T AA R
GUITARIST	G IH T AA R IH S T
GULF	G AH L F
GUN	G AH N
GUNMAN	G AH N M AH N
GUNPOWDER	G AH N P AW D ER
GUT	G AH T
GUY	G AY
GYM	JH IH M
GYMNASIUM	JH IH M N EY Z IY AH M
HABIT	HH AE B AH T
HABITAT	HH AE B AH T AE T
HABITATION	HH AE B AH T EY SH AH N
HACKLES	HH AE K AH L Z
HADDOCK	HH AE D AH K
HAEMORRHAGE	HH IY M AO R AH JH
HAILSTORM	HH EY L S T AO R M
HAIR	HH EH R
HAIRCUT	HH EH R K AH T
HAIRDRESSER	HH EH R D R EH S ER
HAIRSTYLIST	HH EH R S T AY L IH S T
HALF	HH AE F
HALIBUT	HH AE L AH B AH T
HALL	HH AO L
HALLWAY	HH AO L W EY
HALT	HH AO L T
HAM	HH AE M
HAMMER	HH AE M ER
HAMMOCK	HH AE M AH K
HAMSTER	HH AE M S T ER
HAND	HH AE N D
HANDBAG	HH AE N D B AE G
HANDCRAFT	HH AE N D K R AE F T
HANDCUFFS	HH AE N D K AH F S
HANDFUL	HH AE N D F UH L
HANDICAP	HH AE N D IY K AE P
HANDLE	HH AE N D AH L
HANDLING	HH AE N D L IH NG
HANDLING(2)	HH AE N D AH L IH NG
HANGAR	HH AE NG ER
HANGING	HH AE NG IH NG
HANGING(2)	HH AE NG G IH NG
HANGOUT	HH AE NG AW T
HAPPINESS	HH AE P IY N AH S
HARDLINER	HH AA R D L AY N ER
HARDNESS	HH AA R D N AH S
HARDSHIP	HH AA R D SH IH P
HARDWARE	HH AA R D W EH R
HARM	HH AA R M
HARMONY	HH AA R M AH N IY
HARNESS	HH AA R N AH S
HARNESS(2)	HH AA R N IH S
HASH	HH AE SH
HASSLE	HH AE S AH L
HASTE	HH EY S T
HAT	HH AE T
HATE	HH EY T
HATRED	HH EY T R AH D
HAULING	HH AO L IH NG
HAVEN	HH EY V AH N
HAVOC	HH AE V AH K
HAY	HH EY
HAZARD	HH AE Z ER D
HEAD	HH EH D
HEADBOARD	HH EH D B AO R D
HEADER	HH EH D ER
HEADING	HH EH D IH NG
HEADLINE	HH EH D L AY N
HEADQUARTERS	HH EH D K W AO R T ER Z
HEADQUARTERS(2)	HH EH D K AO R T ER Z
HEALING	HH IY L IH NG
HEALTH	HH EH L TH
HEARING	HH IY R IH NG
HEART	HH AA R T
HEAT	HH IY T
HEATER	HH IY T ER
HEATHER	HH EH DH ER
HEATING	HH IY T IH NG
HEAVEN	HH EH V AH N
HEAVYWEIGHT	HH EH V IY W EY T
HECK	HH EH K
HEDGE	HH EH JH
HEDGING	HH EH JH IH NG
HEED	HH IY D
HEEL	HH IY L
HEIFER	HH AY F ER
HEIFER(2)	HH EH F ER
HEIGHT	HH AY T
HELICOPTER	HH EH L IH K AA P T ER
HELL	HH EH L
HELP	HH EH L P
HELPER	HH EH L P ER
HEMISPHERE	HH EH M IH S F IH R
HEN	HH EH N
HERB	ER B
HERB(2)	HH ER B
HERBALIST	ER B AH L IH S T
HERBALIST(2)	HH ER B AH L IH S T
HERD	HH ER D
HERDING	HH ER D IH NG
HERITAGE	HH EH R AH T AH JH
HERITAGE(2)	HH EH R IH T IH JH
HERNIA	HH ER N IY AH
HERO	HH IH R OW
HERO(2)	HH IY R OW
HERPES	HH ER P IY Z
HERRING	HH EH R IH NG
HESITATION	HH EH Z AH T EY SH AH N
HEYDAY	HH EY D EY
HIATUS	HH AY EY T AH S
HIBERNATION	HH AY B ER N EY SH AH N
HIDE	HH AY D
HIDEOUT	HH AY D AW T
HIDING	HH AY D IH NG
HIERARCHY	HH AY ER AA R K IY
HIERARCHY(2)	HH AY R AA R K IY
HIGH	HH AY
HIGHLIGHT	HH AY L AY T
HIGHWAY	HH AY W EY
HIJACKER	HH AY JH AE K ER
HIKE	HH AY K
HILL	HH IH L
HINDSIGHT	HH AY N D S AY T
HINDSIGHT(2)	HH AY N S AY T
HINGE	HH IH N JH
HINT	HH IH N T
HIPPIE	HH IH P IY
HIPPY	HH IH P IY
HISS	HH IH S
HISSING	HH IH S IH NG
HISTORIAN	HH IH S T AO R IY AH N
HISTORY	HH IH S T ER IY
HISTORY(2)	HH IH S T R IY
HIT	HH IH T
HITCH	HH IH CH
HOAX	HH OW K S
HOBBY	HH AA B IY
HOCKEY	HH AA K IY
HOLD	HH OW L D
HOLDER	HH OW L D ER
HOLDING	HH OW L D IH NG
HOLE	HH OW L
HOLIDAY	HH AA L AH D EY
HOLIDAY(2)	HH AA L IH D EY
HOLIDAYING	HH AA L AH D EY IH NG
HOLOCAUST	HH AO L AH K AO S T
HOME	HH OW M
HOMELAND	HH OW M L AE N D
HOMEPAGE	HH OW M P EY JH
HOMEWORK	HH OW M W ER K
HOMOSEXUAL	HH OW M OW S EH K SH UW AH L
HOMOSEXUALITY	HH OW M OW S EH K SH UW AE L AH T IY
HONESTY	AA N AH S T IY
HONEY	HH AH N IY
HONEYMOON	HH AH N IY M UW N
HONOR	AA N ER
HOOD	HH UH D
HOOF	HH UW F
HOOKER	HH UH K ER
HOPE	HH OW P
HOPELESSNESS	HH OW P L AH S N AH S
HORIZON	HH ER AY Z AH N
HORN	HH AO R N
HORNET	HH AO R N IH T
HORROR	HH AO R ER
HORSE	HH AO R S
HOSE	HH OW Z
HOSPITAL	HH AA S P IH T AH L
HOSPITALITY	HH AA S P AH T AE L AH T IY
HOST	HH OW S T
HOSTAGE	HH AA S T IH JH
HOSTESS	HH OW S T AH S
HOSTILITY	HH AA S T IH L AH T IY
HOSTING	HH OW S T IH NG
HOTEL	HH OW T EH L
HOTHEAD	HH AA T HH EH D
HOUR	AW ER
HOUR(2)	AW R
HOUSE	HH AW S
HOUSEHOLD	HH AW S HH OW L D
HOUSING	HH AW Z IH NG
HOW	HH AW
HUB	HH AH B
HUG	HH AH G
HULL	HH AH L
HUMAN	HH Y UW M AH N
HUMAN(2)	Y UW M AH N
HUMANIST	HH Y UW M AH N IH S T
HUMANITY	HH Y UW M AE N IH T IY
HUMANITY(2)	Y UW M AE N IH T IY
HUMILIATION	HH Y UW M IH L IY EY SH AH N
HUMOR	HH Y UW M ER
HUNDRED	HH AH N D R AH D
HUNDRED(2)	HH AH N D R IH D
HUNDRED(3)	HH AH N ER D
HUNDRED(4)	HH AH N D ER D
HUNGER	HH AH NG G ER
HUNK	HH AH NG K
HUNT	HH AH N T
HUNTER	HH AH N T ER
HURDLE	HH ER D AH L
HURRY	HH ER IY
HUSBAND	HH AH Z B AH N D
HUSTLE	HH AH S AH L
HUTCH	HH AH CH
HYBRID	HH AY B R AH D
HYBRID(2)	HH AY B R IH D
HYGIENE	HH AY JH IY N
HYPE	HH AY P
HYPOCRISY	HH IH P AA K R AH S IY
HYSTERIA	HH IH S T EH R IY AH
ICE	AY S
ICEBERG	AY S B ER G
ICING	AY S IH NG
ICON	AY K AA N
IDEA	AY D IY AH
IDEAL	AY D IY L
IDENTIFICATION	AY D EH N T AH F AH K EY SH AH N
IDENTITY	AY D EH N T AH T IY
IDEOLOGY	AY D IY AA L AH JH IY
IDIOT	IH D IY AH T
IGNORAMUS	IH G N ER EY M AH S
IGNORANCE	IH G N ER AH N S
ILK	IH L K
ILLEGAL	IH L IY G AH L
ILLNESS	IH L N AH S
ILLUSION	IH L UW ZH AH N
IMAGE	IH M AH JH
IMAGE(2)	IH M IH JH
IMAGINATION	IH M AE JH AH N EY SH AH N
IMBALANCE	IH M B AE L AH N S
IMMIGRANT	IH M AH G R AH N T
IMMIGRATION	IH M AH G R EY SH AH N
IMMUNITY	IH M Y UW N AH T IY
IMMUNITY(2)	IH M Y UW N IH T IY
IMPACT	IH M P AE K T
IMPASSE	IH M P AE S
IMPLEMENTATION	IH M P L AH M EH N T EY SH AH N
IMPLICATION	IH M P L AH K EY SH AH N
IMPORTANCE	IH M P AO R T AH N S
IMPOSTER	IH M P AO S T ER
IMPRESSION	IH M P R EH SH AH N
IMPRISONMENT	IH M P R IH Z AH N M AH N T
IMPROVEMENT	IH M P R UW V M AH N T
INABILITY	IH N AH B IH L IH T IY
INCENTIVE	IH N S EH N T IH V
INCENTIVE(2)	IH N S EH N IH V
INCEPTION	IH N S EH P SH AH N
INCH	IH N CH
INCIDENT	IH N S AH D AH N T
INCITEMENT	IH N S AY T M AH N T
INCLUSION	IH N K L UW ZH AH N
INCOME	IH N K AH M
INCOMPETENCE	IH N K AA M P AH T AH N S
INCONSISTENCY	IH N K AH N S IH S T AH N S IY
INCREASE	IH N K R IY S
INCREDULITY	IH N K R AH D UW L IH T IY
INCUBATION	IH NG K Y UW B EY SH AH N
INDEX	IH N D EH K S
INDICATION	IH N D AH K EY SH AH N
INDICATOR	IH N D AH K EY T ER
INDIGNITY	IH N D IH G N AH T IY
INDIVIDUAL	IH N D AH V IH JH AH W AH L
INDUSTRIALIST	IH N D AH S T R IY AH L IH S T
INDUSTRY	IH N D AH S T R IY
INEQUITY	IH N EH K W AH T IY
INFANT	IH N F AH N T
INFANTRY	IH N F AH N T R IY
INFECTION	IH N F EH K SH AH N
INFERIORITY	IH N F IH R IY AO R IH T IY
INFERTILITY	IH N F ER T IH L IH T IY
INFIDEL	IH N F IH D EH L
INFILTRATOR	IH N F IH L T R EY T ER
INFINITY	IH N F IH N IH T IY
INFLATION	IH N F L EY SH AH N
INFLUENCE	IH N F L UW AH N S
INFLUX	IH N F L AH K S
INFO	IH N F OW
INFORMATION	IH N F AO R M EY SH AH N
INFRASTRUCTURE	IH N F R AH S T R AH K CH ER
INGREDIENT	IH N G R IY D IY AH N T
INITIAL	IH N IH SH AH L
INITIATIVE	IH N IH SH AH T IH V
INITIATIVE(2)	IH N IH SH Y AH T IH V
INJECTION	IH N JH EH K SH AH N
INJURY	IH N JH ER IY
INJUSTICE	IH N JH AH S T IH S
INK	IH NG K
INN	IH N
INNKEEPER	IH N K IY P ER
INNOCENT	IH N AH S AH N T
INNOVATION	IH N AH V EY SH AH N
INNOVATION(2)	IH N OW V EY SH AH N
INPUT	IH N P UH T
INQUIRE	IH N K W AY R
INQUIRY	IH N K W AY R IY
INQUIRY(2)	IH N K W AH R IY
INSECT	IH N S EH K T
INSERT	IH N S ER T
INSIDE	IH N S AY D
INSIDER	IH N S AY D ER
INSIGHT	IH N S AY T
INSOMNIA	IH N S AA M N IY AH
INSPECTION	IH N S P EH K SH AH N
INSPECTOR	IH N S P EH K T ER
INSTABILITY	IH N S T AH B IH L IH T IY
INSTALLATION	IH N S T AH L EY SH AH N
INSTANCE	IH N S T AH N S
INSTANT	IH N S T AH N T
INSTINCT	IH N S T IH NG K T
INSTITUTION	IH N S T IH T UW SH AH N
INSTRUCTION	IH N S T R AH K SH AH N
INSTRUCTOR	IH N S T R AH K T ER
INSTRUMENTATION	IH N S T R AH M EH N T EY SH AH N
INSULATION	IH N S AH L EY SH AH N
INSULT	IH N S AH L T
INSURANCE	IH N SH UH R AH N S
INSURER	IH N SH UH R ER
INSURGENCY	IH N S ER JH AH N S IY
INSURGENT	IH N S ER JH AH N T
INSURGENTS	IH N S ER JH AH N T S
INTAKE	IH N T EY K
INTEGRITY	IH N T EH G R AH T IY
INTELLECT	IH N T AH L EH K T
INTELLECT(2)	IH N AH L EH K T
INTELLECTUAL	IH N T AH L EH K CH UW AH L
INTELLECTUAL(2)	IH N AH L EH K CH UW AH L
INTELLIGENCE	IH N T EH L AH JH AH N S
INTENT	IH N T EH N T
INTENTION	IH N T EH N CH AH N
INTERACTION	IH N T ER AE K SH AH N
INTERACTION(2)	IH N ER AE K SH AH N
INTERCEPT	IH N T ER S EH P T
INTERCEPT(2)	IH N ER S EH P T
INTERCEPTION	IH N T ER S EH P SH AH N
INTERCEPTION(2)	IH N ER S EH P SH AH N
INTERCEPTOR	IH N T ER S EH P T ER
INTERCEPTOR(2)	IH N ER S EH P T ER
INTERCONNECT	IH N T ER K AH N EH K T
INTERCOURSE	IH N T ER K AO R S
INTERCOURSE(2)	IH N ER K AO R S
INTEREST	IH N T AH R EH S T
INTERESTING	IH N T AH R EH S T IH NG
INTERFACE	IH N T ER F EY S
INTERFACE(2)	IH N ER F EY S
INTERFERENCE	IH N T ER F IH R AH N S
INTERFERENCE(2)	IH N ER F IH R AH N S
INTERMEDIARY	IH N ER M IY D IY EH R IY
INTERMEDIARY(2)	IH N T ER M IY D IY EH R IY
INTERN	IH N T ER N
INTERNET	IH N T ER N EH T
INTERROGATION	IH N T EH R AH G EY SH AH N
INTERROGATOR	IH N T EH R AH G EY T ER
INTERVENTION	IH N T ER V EH N SH AH N
INTERVIEW	IH N T ER V Y UW
INTERVIEWER	IH N T ER V Y UW ER
INTESTINE	IH N T EH S T AH N
INTESTINE(2)	IH N T EH S T AY N
INTIMACY	IH N T AH M AH S IY
INTO	IH N T UW
INTO(2)	IH N T AH
INTOLERANCE	IH N T AA L ER AH N S
INTRIGUE	IH N T R IY G
INTRODUCTION	IH N T R AH D AH K SH AH N
INTRODUCTION(2)	IH N T R OW D AH K SH AH N
INTROSPECTION	IH N T R AH S P EH K SH AH N
INTROSPECTION(2)	IH N T R OW S P EH K SH AH N
INTRUDER	IH N T R UW D ER
INTRUSION	IH N T R UW ZH AH N
INTUITION	IH N T UW IH SH AH N
INVASION	IH N V EY ZH AH N
INVENTION	IH N V EH N SH AH N
INVENTORY	IH N V AH N T AO R IY
INVERSION	IH N V ER ZH AH N
INVESTIGATION	IH N V EH S T AH G EY SH AH N
INVESTIGATOR	IH N V EH S T AH G EY T ER
INVESTMENT	IH N V EH S T M AH N T
INVESTMENT(2)	IH N V EH S M AH N T
INVESTOR	IH N V EH S T ER
INVITATION	IH N V IH T EY SH AH N
INVOICE	IH N V OY S
INVOICING	IH N V OY S IH NG
INVOLVEMENT	IH N V AA L V M AH N T
IRON	AY ER N
IRONY	AY R AH N IY
IRREGULARITY	IH R EH G Y AH L EH R AH T IY
IRRITATION	IH R IH T EY SH AH N
ISLAND	AY L AH N D
ISSUE	IH SH UW
ITEM	AY T AH M
ITINERARY	AY T IH N ER EH R IY
JACK	JH AE K
JACKET	JH AE K AH T
JACKET(2)	JH AE K IH T
JAIL	JH EY L
JAR	JH AA R
JAW	JH AO
JAZZ	JH AE Z
JEANS	JH IY N Z
JERK	JH ER K
JESTER	JH EH S T ER
JET	JH EH T
JEWELRY	JH UW AH L R IY
JEWELRY(2)	JH UW L R IY
JEWELRY(3)	JH UW L ER IY
JIHAD	JH IY HH AA D
JIMMY	JH IH M IY
JOB	JH AA B
JOB(2)	JH OW B
JOG	JH AA G
JOINT	JH OY N T
JOKE	JH OW K
JOURNAL	JH ER N AH L
JOURNALIST	JH ER N AH L AH S T
JOURNALIST(2)	JH ER N AH L IH S T
JOURNEY	JH ER N IY
JOY	JH OY
JOYSTICK	JH OY S T IH K
JUDGE	JH AH JH
JUDGEMENT	JH AH JH M AH N T
JUDGMENT	JH AH JH M AH N T
JUG	JH AH G
JUGGLING	JH AH G AH L IH NG
JUGGLING(2)	JH AH G L IH NG
JUGULAR	JH UW G Y AH L ER
JUICE	JH UW S
JUMBO	JH AH M B OW
JUMP	JH AH M P
JUNK	JH AH NG K
JUNKIE	JH AH NG K IY
JURISDICTION	JH UH R AH S D IH K SH AH N
JURISDICTION(2)	JH UH R IH S D IH K SH AH N
JURY	JH UH R IY
JUSTICE	JH AH S T AH S
JUSTICE(2)	JH AH S T IH S
JUSTIFICATION	JH AH S T AH F AH K EY SH AH N
JUVENILE	JH UW V AH N AH L
JUVENILE(2)	JH UW V AH N AY L
KALE	K EY L
KARMA	K AA R M AH
KEEP	K IY P
KEEPING	K IY P IH NG
KENNEL	K EH N AH L
KEY	K IY
KEYSTONE	K IY S T OW N
KEYWORD	K IY W ER D
KHAKI	K AA K IY
KHAKI(2)	K AE K IY
KICK	K IH K
KID	K IH D
KIDDIE	K IH D IY
KIDDING	K IH D IH NG
KIDNAPPING	K IH D N AE P IH NG
KIDNEY	K IH D N IY
KILL	K IH L
KILLER	K IH L ER
KILLING	K IH L IH NG
KILN	K IH L N
KILOMETER	K AH L AA M AH T ER
KILOMETER(2)	K IH L AH M IY T ER
KIND	K AY N D
KINDERGARTEN	K IH N D ER G AA R T AH N
KINDNESS	K AY N D N AH S
KING	K IH NG
KITCHEN	K IH CH AH N
KITTEN	K IH T AH N
KITTY	K IH T IY
KNEE	N IY
KNIFE	N AY F
KNOCK	N AA K
KNOW	N OW
KNOWLEDGE	N AA L AH JH
KNOWLEDGE(2)	N AA L IH JH
LAB	L AE B
LABEL	L EY B AH L
LABOR	L EY B ER
LABORER	L EY B ER ER
LABYRINTH	L AE B ER IH N TH
LACK	L AE K
LADY	L EY D IY
LAMB	L AE M
LAMP	L AE M P
LAND	L AE N D
LANDING	L AE N D IH NG
LANDLORD	L AE N D L AO R D
LANDMARK	L AE N D M AA R K
LANDSCAPE	L AE N D S K EY P
LANDSCAPE(2)	L AE N S K EY P
LANE	L EY N
LANGUAGE	L AE NG G W AH JH
LANGUAGE(2)	L AE NG G W IH JH
LAP	L AE P
LAPSE	L AE P S
LAPTOP	L AE P T AA P
LASCIVIOUSNESS	L AH S IH V IY AH S N AH S
LASER	L EY Z ER
LATER	L EY T ER
LATITUDES	L AE T AH T UW D Z
LAUGHTER	L AE F T ER
LAUNCH	L AO N CH
LAUNCHER	L AO N CH ER
LAUNCHING	L AO N CH IH NG
LAUNDRY	L AO N D R IY
LAUREL	L AO R AH L
LAVA	L AA V AH
LAW	L AO
LAW(2)	L AA
LAWLESSNESS	L AO L AH S N AH S
LAWMAKER	L AO M EY K ER
LAWSUIT	L AO S UW T
LAWYER	L AO Y ER
LAWYER(2)	L OY ER
LAYER	L EY ER
LAYOUT	L EY AW T
LEAD	L EH D
LEAD(2)	L IY D
LEADER	L IY D ER
LEADERSHIP	L IY D ER SH IH P
LEAF	L IY F
LEAFLET	L IY F L AH T
LEAFY	L IY F IY
LEAK	L IY K
LEAKAGE	L IY K AH JH
LEAKAGE(2)	L IY K IH JH
LEAP	L IY P
LEARNING	L ER N IH NG
LEASE	L IY S
LEASH	L IY SH
LEATHER	L EH DH ER
LEAVE	L IY V
LECTURE	L EH K CH ER
LEDGER	L EH JH ER
LEFT	L EH F T
LEG	L EH G
LEGACY	L EH G AH S IY
LEGAL	L IY G AH L
LEGEND	L EH JH AH N D
LEGISLATURE	L EH JH AH S L EY CH ER
LEGITIMACY	L AH JH IH T AH M AH S IY
LEGITIMACY(2)	L IH JH IH T AH M AH S IY
LEISURE	L EH ZH ER
LEISURE(2)	L IY ZH ER
LEMONADE	L EH M AH N EY D
LENGTH	L EH NG K TH
LENGTH(2)	L EH NG TH
LENS	L EH N Z
LESION	L IY ZH AH N
LESSON	L EH S AH N
LET	L EH T
LETHARGY	L EH TH ER JH IY
LETTER	L EH T ER
LETTUCE	L EH T AH S
LEVEL	L EH V AH L
LEVERAGE	L EH V ER IH JH
LEVERAGE(2)	L EH V R AH JH
LEVERAGE(3)	L IY V ER IH JH
LIABILITY	L AY AH B IH L IH T IY
LIAR	L AY ER
LIBEL	L AY B EH L
LIBERAL	L IH B ER AH L
LIBERATION	L IH B ER EY SH AH N
LIBERTARIAN	L IH B ER T EH R IY AH N
LIBERTY	L IH B ER T IY
LICENSE	L AY S AH N S
LIE	L AY
LIEU	L UW
LIEU(2)	L Y UW
LIEUTENANT	L UW T EH N AH N T
LIFE	L AY F
LIFEBOAT	L AY F B OW T
LIFEGUARD	L AY F G AA R D
LIFESPAN	L AY F S P AE N
LIFESTYLE	L AY F S T AY L
LIFETIME	L AY F T AY M
LIFT	L IH F T
LIGHT	L AY T
LIGHTING	L AY T IH NG
LIKES	L AY K S
LIMB	L IH M
LIMBO	L IH M B OW
LIMIT	L IH M AH T
LIMITATION	L IH M IH T EY SH AH N
LINE	L AY N
LINEN	L IH N AH N
LINER	L AY N ER
LINGUIST	L IH NG G W IH S T
LINK	L IH NG K
LION	L AY AH N
LIP	L IH P
LIPID	L AY P AH D
LIQUIDATION	L IH K W IH D EY SH AH N
LIQUOR	L IH K ER
LISP	L IH S P
LIST	L IH S T
LISTENER	L IH S AH N ER
LISTENER(2)	L IH S N ER
LISTENING	L IH S AH N IH NG
LISTENING(2)	L IH S N IH NG
LISTING	L IH S T IH NG
LISTLESSNESS	L IH S T L AH S N AH S
LITERATURE	L IH T ER AH CH ER
LITHOGRAPH	L IH TH AH G R AE F
LITIGATION	L IH T AH G EY SH AH N
LITTER	L IH T ER
LITTLE	L IH T AH L
LIVE	L AY V
LIVE(2)	L IH V
LIVER	L IH V ER
LIVESTOCK	L AY V S T AA K
LIVING	L IH V IH NG
LIZARD	L IH Z ER D
LOAD	L OW D
LOADING	L OW D IH NG
LOAN	L OW N
LOBBY	L AA B IY
LOBBYIST	L AA B IY AH S T
LOBSTER	L AA B S T ER
LOCATION	L OW K EY SH AH N
LOCK	L AA K
LOCKER	L AA K ER
LODGE	L AA JH
LODGING	L AA JH IH NG
LOGIC	L AA JH IH K
LOGO	L OW G OW
LONG	L AO NG
LONGEVITY	L AO N JH EH V AH T IY
LONGSHOREMAN	L AO NG SH OW R M AE N
LOOK	L UH K
LOOKOUT	L UH K AW T
LOOP	L UW P
LOOSER	L UW S ER
LOOT	L UW T
LOOTER	L UW T ER
LOOTING	L UW T IH NG
LOPE	L OW P
LOSER	L UW Z ER
LOSS	L AO S
LOT	L AA T
LOT(2)	L AO T
LOTTERY	L AA T ER IY
LOTUS	L OW T AH S
LOUNGE	L AW N JH
LOVE	L AH V
LOVER	L AH V ER
LOW	L OW
LUBE	L UW B
LUCK	L AH K
LUNATIC	L UW N AH T IH K
LUNCH	L AH N CH
LUNCHEON	L AH N CH AH N
LUNG	L AH NG
LUXURY	L AH G ZH ER IY
LYMPHOMA	L IH M F OW M AH
LYRIC	L IH R IH K
MACHINE	M AH SH IY N
MACROCOSM	M AE K R AH K AH Z AH M
MADAM	M AE D AH M
MAGAZINE	M AE G AH Z IY N
MAGIC	M AE JH IH K
MAGICIAN	M AH JH IH SH AH N
MAGNESIUM	M AE G N IY Z IY AH M
MAGNET	M AE G N AH T
MAGNITUDE	M AE G N AH T UW D
MAID	M EY D
MAIL	M EY L
MAILER	M EY L ER
MAILING	M EY L IH NG
MAINSTREAM	M EY N S T R IY M
MAINTENANCE	M EY N T AH N AH N S
MAINTENANCE(2)	M EY N T N AH N S
MAJORITY	M AH JH AO R AH T IY
MAKER	M EY K ER
MAKING	M EY K IH NG
MALE	M EY L
MALL	M AO L
MAMA	M AA M AH
MAN	M AE N
MANAGEMENT	M AE N AH JH M AH N T
MANAGEMENT(2)	M AE N IH JH M AH N T
MANAGER	M AE N AH JH ER
MANAGER(2)	M AE N IH JH ER
MANGER	M EY N JH ER
MANGO	M AE NG G OW
MANHUNT	M AE N HH AH N T
MANIAC	M EY N IY AE K
MANICURE	M AE N IH K Y ER
MANIFESTATION	M AE N AH F EH S T EY SH AH N
MANIFOLD	M AE N AH F OW L D
MANIFOLD(2)	M AE N IH F OW L D
MANIKIN	M AE N IH K AH N
MANKIND	M AE N K AY N D
MANLINESS	M AE N L IY N AH S
MANNER	M AE N ER
MANNERS	M AE N ER Z
MANTRA	M AE N T R AH
MANUAL	M AE N Y UW AH L
MANUFACTURE	M AE N Y AH F AE K CH ER
MANUFACTURER	M AE N Y AH F AE K CH ER ER
MANUFACTURING	M AE N Y AH F AE K CH ER IH NG
MANY	M EH N IY
MAP	M AE P
MAPLE	M EY P AH L
MAPPING	M AE P IH NG
MARCH	M AA R CH
MARE	M EH R
MARGARITA	M AA R G ER IY T AH
MARGIN	M AA R JH AH N
MARIONETTE	M AE R IY AH N EH T
MARK	M AA R K
MARKET	M AA R K AH T
MARKET(2)	M AA R K IH T
MARKETER	M AA R K AH T ER
MARKETING	M AA R K AH T IH NG
MARKETPLACE	M AA R K AH T P L EY S
MARKETPLACE(2)	M AA R K IH T P L EY S
MARKING	M AA R K IH NG
MARRIAGE	M EH R IH JH
MARRYING	M EH R IY IH NG
MARTYR	M AA R T ER
MASK	M AE S K
MASQUERADE	M AE S K ER EY D
MASS	M AE S
MASSACRE	M AE S AH K ER
MASSAGE	M AH S AA ZH
MASTER	M AE S T ER
MASTERMIND	M AE S T ER M AY N D
MATCH	M AE CH
MATCHING	M AE CH IH NG
MATE	M EY T
MATERIAL	M AH T IH R IY AH L
MATH	M AE TH
MATHEMATICS	M AE TH AH M AE T IH K S
MATRIX	M EY T R IH K S
MATTER	M AE T ER
MAW	M AO
MAXIMUM	M AE K S AH M AH M
MAYONNAISE	M EY AH N EY Z
MAYOR	M EY ER
MEADOWLARK	M EH D OW L AA R K
MEAL	M IY L
MEAN	M IY N
MEANING	M IY N IH NG
MEANS	M IY N Z
MEANTIME	M IY N T AY M
MEANWHILE	M IY N W AY L
MEASURE	M EH ZH ER
MEAT	M IY T
MEATBALL	M IY T B AO L
MECHANIC	M AH K AE N IH K
MECHANIC(2)	M IH K AE N IH K
MECHANICS	M AH K AE N IH K S
MECHANISM	M EH K AH N IH Z AH M
MEDAL	M EH D AH L
MEDIA	M IY D IY AH
MEDIATION	M IY D IY EY SH AH N
MEDICATION	M EH D AH K EY SH AH N
MEDICINE	M EH D AH S AH N
MEDITATION	M EH D AH T EY SH AH N
MEDIUM	M IY D IY AH M
MEETING	M IY T IH NG
MEGAPIXEL	M EH G AH P IH K S AH L
MELTING	M EH L T IH NG
MEMBER	M EH M B ER
MEMBERSHIP	M EH M B ER SH IH P
MEMBRANE	M EH M B R EY N
MEMO	M EH M OW
MEMOIR	M EH M W AA R
MEMORY	M EH M ER IY
MENACE	M EH N AH S
MENACE(2)	M EH N IH S
MENSTRUATION	M EH N S T R UW EY SH AH N
MENU	M EH N Y UW
MEOWING	M IY OW AH NG
MERCENARY	M ER S AH N EH R IY
MERCHANT	M ER CH AH N T
MERCURY	M ER K Y ER IY
MERCY	M ER S IY
MERGER	M ER JH ER
MERIT	M EH R AH T
MESH	M EH SH
MESS	M EH S
MESSAGE	M EH S AH JH
MESSAGE(2)	M EH S IH JH
METABOLISM	M AH T AE B AH L IH Z AH M
METAL	M EH T AH L
METAPHOR	M EH T AH F AO R
METASTASIS	M AH T AE S T AH S IH S
METER	M IY T ER
METERING	M IY T ER IH NG
METHOD	M EH TH AH D
METHODOLOGY	M EH TH AH D AA L AH JH IY
METRO	M EH T R OW
MICROBIOLOGIST	M AY K R OW B IY AA L AH JH IH S T
MICROCOMPUTER	M AY K R OW K AH M P Y UW T ER
MICROCOSM	M AY K R AH K AA Z AH M
MICRON	M AY K R AA N
MICROPHONE	M AY K R AH F OW N
MICROWAVE	M AY K R AH W EY V
MIDDLE	M IH D AH L
MIDGET	M IH JH AH T
MIDST	M IH D S T
MIDST(2)	M IH S T
MIDTERM	M IH D T ER M
MIGRANT	M AY G R AH N T
MIGRATION	M AY G R EY SH AH N
MILDEW	M IH L D UW
MILE	M AY L
MILEAGE	M AY L AH JH
MILEAGE(2)	M AY L IH JH
MILIEU	M IH L Y UH
MILITANT	M IH L AH T AH N T
MILITARISM	M IH L AH T ER IH Z AH M
MILITARY	M IH L AH T EH R IY
MILITARY(2)	M IH L IH T EH R IY
MILITIA	M AH L IH SH AH
MILITIA(2)	M IH L IH SH AH
MILK	M IH L K
MILL	M IH L
MILLENNIUM	M AH L EH N IY AH M
MILLET	M IH L AH T
MILLING	M IH L IH NG
MILLION	M IH L Y AH N
MIMOSA	M IH M OW S AH
MIND	M AY N D
MINE	M AY N
MINERAL	M IH N ER AH L
MINERAL(2)	M IH N R AH L
MINIATURE	M IH N IY AH CH UH R
MINIATURE(2)	M IH N IH CH UH R
MINIMUM	M IH N AH M AH M
MINING	M AY N IH NG
MINISTER	M IH N AH S T ER
MINISTER(2)	M IH N IH S T ER
MINORITY	M AY N AO R AH T IY
MINORITY(2)	M AH N AO R AH T IY
MINUTE	M IH N AH T
MINUTE(2)	M AY N UW T
MINUTE(3)	M AY N Y UW T
MIRACLE	M IH R AH K AH L
MIRTH	M ER TH
MISANTHROPY	M IH S AH N TH R OW P IY
MISCHIEF	M IH S CH AH F
MISCONCEPTION	M IH S K AH N S EH P SH AH N
MISCREANT	M IH S K R IY AH N T
MISDIRECTION	M IH S D AH R EH K SH AH N
MISERY	M IH Z ER IY
MISFORTUNE	M IH S F AO R CH AH N
MISINFORMATION	M IH S IH N F ER M EY SH AH N
MISOGYNY	M IH Z AH JH IH N IY
MISSILE	M IH S AH L
MISSION	M IH SH AH N
MISSIVE	M IH S IH V
MISSTATEMENT	M IH S T EY T M AH N T
MIST	M IH S T
MISTAKE	M IH S T EY K
MISTREATMENT	M IH S T R IY T M AH N T
MISUNDERSTANDING	M IH S AH N D ER S T AE N D IH NG
MITIGATING	M IH T AH G EY T IH NG
MIX	M IH K S
MIXING	M IH K S IH NG
MIXTURE	M IH K S CH ER
MOD	M AO D
MODE	M OW D
MODEL	M AA D AH L
MODELING	M AA D AH L IH NG
MODELING(2)	M AA D L IH NG
MODEM	M OW D AH M
MODERATE	M AA D ER AH T
MODERATE(2)	M AA D ER EY T
MODERATOR	M AA D ER EY T ER
MODERNIZATION	M AA D ER N AH Z EY SH AH N
MODERNIZATION(2)	M AA D ER N AY Z EY SH AH
MODICUM	M AA D IH K AH M
MODULE	M AA JH UW L
MOISTURE	M OY S CH ER
MOLD	M OW L D
MOLDING	M OW L D IH NG
MOLE	M OW L
MOLESTER	M AH L EH S T ER
MOM	M AA M
MOMENT	M OW M AH N T
MOMMY	M AA M IY
MONARCHY	M AA N AA R K IY
MONEY	M AH N IY
MONKEY	M AH NG K IY
MONOPOLY	M AH N AA P AH L IY
MONOTONY	M AH N AA T AH N IY
MONTH	M AH N TH
MOO	M UW
MOON	M UW N
MOOR	M UH R
MOORLAND	M UH R L AE N D
MOP	M AA P
MORALE	M ER AE L
MORALITY	M AO R AE L AH T IY
MORBIDITY	M AO R B IH D AH T IY
MORNING	M AO R N IH NG
MORTAR	M AO R T ER
MOSQUE	M AA S K
MOSQUE(2)	M AO S K
MOSQUITO	M AH S K IY T OW
MOTEL	M OW T EH L
MOTHER	M AH DH ER
MOTION	M OW SH AH N
MOTIVATION	M OW T AH V EY SH AH N
MOTIVE	M OW T IH V
MOTOR	M OW T ER
MOTORCYCLE	M OW T ER S AY K AH L
MOTTO	M AA T OW
MOUND	M AW N D
MOUNTAIN	M AW N T AH N
MOUNTAINTOP	M AW N T AH N T AA P
MOUNTING	M AW N T IH NG
MOUSE	M AW S
MOUSEY	M AW S IY
MOUSSE	M UW S
MOUTH	M AW TH
MOUTHPIECE	M AW TH P IY S
MOVE	M UW V
MOVEMENT	M UW V M AH N T
MOVIE	M UW V IY
MOVING	M UW V IH NG
MUCH	M AH CH
MUD	M AH D
MUFF	M AH F
MULLAH	M AH L AH
MULTIPLEX	M AH L T IY P L EH K S
MULTITUDE	M AH L T AH T UW D
MULTITUDE(2)	M AH L T AH T Y UW D
MUNICIPALITY	M Y UW N IH S AH P AE L AH T IY
MURDER	M ER D ER
MURDERER	M ER D ER ER
MURDERING	M ER D ER IH NG
MUSCLE	M AH S AH L
MUSEUM	M Y UW Z IY AH M
MUSH	M AH SH
MUSIC	M Y UW Z IH K
MUSICAL	M Y UW Z IH K AH L
MUSICIAN	M Y UW Z IH SH AH N
MUSK	M AH S K
MUSSEL	M AH S AH L
MUSTER	M AH S T ER
MUTILATION	M Y UW T AH L EY SH AH N
MUTT	M AH T
MYSTERY	M IH S T ER IY
MYSTICISM	M IH S T IH S IH Z AH M
MYTH	M IH TH
NACHO	N AE CH OW
NACHO(2)	N AA CH OW
NAIL	N EY L
NAIVETY	N AA IY V AH T EY IY
NAME	N EY M
NAMING	N EY M IH NG
NAPKIN	N AE P K IH N
NATION	N EY SH AH N
NATIONAL	N AE SH AH N AH L
NATIONAL(2)	N AE SH N AH L
NATIONALISM	N AE SH AH N AH L IH Z AH M
NATIONALIST	N AE SH AH N AH L AH S T
NATIONALIST(2)	N AE SH AH N AH L IH S T
NATIONALIST(3)	N AE SH N AH L AH S T
NATIONALIST(4)	N AE SH N AH L IH S T
NATIONALITY	N AE SH AH N AE L AH T IY
NATIONALITY(2)	N AE SH AH N AE L IH T IY
NATIVE	N EY T IH V
NATURE	N EY CH ER
NAUSEA	N AO Z IY AH
NAVIGATION	N AE V AH G EY SH AH N
NAVY	N EY V IY
NECESSITY	N AH S EH S AH T IY
NECESSITY(2)	N AH S EH S IH T IY
NECK	N EH K
NEED	N IY D
NEEDLE	N IY D AH L
NEGATIVE	N EH G AH T IH V
NEGLIGENCE	N EH G L AH JH AH N S
NEGLIGENCE(2)	N EH G L IH JH AH N S
NEGOTIATING	N IH G OW SH IY EY T IH NG
NEGOTIATION	N IH G OW SH IY EY SH AH N
NEGOTIATOR	N AH G OW SH IY EY T ER
NEGOTIATOR(2)	N IH G OW SH IY EY T ER
NEIGHBOR	N EY B ER
NEIGHBORHOOD	N EY B ER HH UH D
NEON	N IY AA N
NEPHEW	N EH F Y UW
NERD	N ER D
NERVE	N ER V
NEST	N EH S T
NET	N EH T
NETTING	N EH T IH NG
NETWORK	N EH T W ER K
NETWORKING	N EH T W ER K IH NG
NEUROLOGY	N UH R AA L AH JH IY
NEUTER	N UW T ER
NEW	N UW
NEW(2)	N Y UW
NEWBORN	N UW B AO R N
NEWS	N UW Z
NEWS(2)	N Y UW Z
NEWSLETTER	N UW Z L EH T ER
NEWSPAPER	N UW Z P EY P ER
NICE	N AY S
NICE(2)	N IY S
NICHE	N IH SH
NICHE(2)	N IH CH
NICK	N IH K
NICKNAME	N IH K N EY M
NIGHT	N AY T
NIGHTLIFE	N AY T L AY F
NIGHTMARE	N AY T M EH R
NITROGEN	N AY T R AH JH AH N
NODE	N OW D
NOISE	N OY Z
NOMENCLATURE	N OW M AH N K L EY CH ER
NOMINATION	N AA M AH N EY SH AH N
NONE	N AH N
NOON	N UW N
NORM	N AO R M
NORMAL	N AO R M AH L
NORMALITY	N AO R M AE L AH T IY
NORTH	N AO R TH
NORTHEAST	N AO R TH IY S T
NORTHWEST	N AO R TH W EH S T
NOSE	N OW Z
NOSTRIL	N AA S T R IH L
NOTCH	N AA CH
NOTE	N OW T
NOTEBOOK	N OW T B UH K
NOTEPAD	N OW T P AE D
NOTICE	N OW T AH S
NOTICE(2)	N OW T IH S
NOTIFICATION	N OW T AH F AH K EY SH AH N
NOTION	N OW SH AH N
NOVEL	N AA V AH L
NUDE	N UW D
NUDGING	N AH JH IH NG
NUKE	N UW K
NUMBER	N AH M B ER
NUN	N AH N
NURSE	N ER S
NUTRIENT	N UW T R IY AH N T
OAK	OW K
OATMEAL	OW T M IY L
OBEDIENCE	OW B IY D IY AH N S
OBESITY	OW B IY S AH T IY
OBESITY(2)	AH B IY S AH T IY
OBJECT	AA B JH EH K T
OBJECT(2)	AH B JH EH K T
OBJECTION	AH B JH EH K SH AH N
OBJECTIVE	AH B JH EH K T IH V
OBLIGATION	AA B L AH G EY SH AH N
OBSCURITY	AH B S K Y UH R AH T IY
OBSERVATION	AA B Z ER V EY SH AH N
OBSERVER	AH B Z ER V ER
OBSTACLE	AA B S T AH K AH L
OBSTRUCTION	AH B S T R AH K SH AH N
OCCASION	AH K EY ZH AH N
OCCUPANCY	AA K Y AH P AH N S IY
OCCUPATION	AA K Y AH P EY SH AH N
OCCURRENCE	AH K ER AH N S
OCEAN	OW SH AH N
O'CLOCK	AH K L AA K
OFF	AO F
OFFENSIVE	AH F EH N S IH V
OFFER	AO F ER
OFFERING	AO F ER IH NG
OFFERING(2)	AO F R IH NG
OFFICE	AO F AH S
OFFICER	AO F AH S ER
OFFICER(2)	AO F IH S ER
OFFICIAL	AH F IH SH AH L
OFFSPRING	AO F S P R IH NG
OIL	OY L
OILFIELD	OY L F IY L D
OLD	OW L D
OMELET	AA M L AH T
OMISSION	OW M IH SH AH N
OMNIBUS	AA M N AH B AH S
ONCE	W AH N S
ONE	W AH N
ONE(2)	HH W AH N
ONION	AH N Y AH N
ONLINE	AO N L AY N
OPEN	OW P AH N
OPENER	OW P AH N ER
OPENING	OW P AH N IH NG
OPERA	AA P R AH
OPERATING	AA P ER EY T IH NG
OPERATING(2)	AO P ER EY T IH NG
OPERATION	AA P ER EY SH AH N
OPERATIVE	AA P ER AH T IH V
OPERATOR	AA P ER EY T ER
OPINION	AH P IH N Y AH N
OPOSSUM	OW P AA S AH M
OPPORTUNITY	AA P ER T UW N AH T IY
OPPOSITE	AA P AH Z IH T
OPPOSITION	AA P AH Z IH SH AH N
OPTIMIZATION	AA P T AH M AH Z EY SH AH N
OPTION	AA P SH AH N
OPTION(2)	AO P SH AH N
ORANGE	AO R AH N JH
ORANGE(2)	AO R IH N JH
ORBIT	AO R B AH T
ORCHESTRA	AO R K AH S T R AH
ORDEAL	AO R D IY L
ORDER	AO R D ER
ORDERING	AO R D ER IH NG
OREGANO	AO R EH G AH N OW
OREGANO(2)	ER EH G AH N OW
ORGAN	AO R G AH N
ORGANISM	AO R G AH N IH Z AH M
ORGANIZATION	AO R G AH N AH Z EY SH AH N
ORGANIZING	AO R G AH N AY Z IH NG
ORIENTATION	AO R IY EH N T EY SH AH N
ORIGAMI	AO R IY G AA M IY
ORIGIN	AO R AH JH AH N
ORIGINAL	ER IH JH AH N AH L
ORIGINATION	ER IH JH AH N EY SH AH N
ORNAMENT	AO R N AH M AH N T
ORPHAN	AO R F AH N
ORTHODONTIST	AO R TH AH D AA N T AH S T
OSTRICH	AO S T R IH CH
OTHER	AH DH ER
OUNCE	AW N S
OUSTER	AW S T ER
OUSTING	AW S T IH NG
OUT	AW T
OUTAGE	AW T AH JH
OUTAGE(2)	AW T IH JH
OUTBREAK	AW T B R EY K
OUTCOME	AW T K AH M
OUTFIT	AW T F IH T
OUTGROWTH	AW T G R OW TH
OUTING	AW T IH NG
OUTLET	AW T L EH T
OUTLINE	AW T L AY N
OUTPUT	AW T P UH T
OUTRAGE	AW T R EY JH
OUTREACH	AW T R IY CH
OUTSIDER	AW T S AY D ER
OVEN	AH V AH N
OVER	OW V ER
OVERAGE	OW V ER EY JH
OVERCHARGE	OW V ER CH AA R JH
OVERDOSE	OW V ER D OW S
OVERFLOW	OW V ER F L OW
OVERNIGHT	OW V ER N AY T
OVERSTATEMENT	OW V ER S T EY T M AH N T
OVERTHROW	OW V ER TH R OW
OVERTURE	OW V ER CH ER
OVERVIEW	OW V ER V Y UW
OWNER	OW N ER
OWNERSHIP	OW N ER SH IH P
OXYGEN	AA K S AH JH AH N
OXYGEN(2)	AA K S IH JH AH N
PACE	P EY S
PACK	P AE K
PACKAGE	P AE K AH JH
PACKAGE(2)	P AE K IH JH
PACKER	P AE K ER
PACKET	P AE K AH T
PACKET(2)	P AE K IH T
PACT	P AE K T
PAD	P AE D
PAGE	P EY JH
PAGER	P EY JH ER
PAIN	P EY N
PAINT	P EY N T
PAINTER	P EY N T ER
PAINTER(2)	P EY N ER
PAINTING	P EY N T IH NG
PAINTING(2)	P EY N IH NG
PAIR	P EH R
PAL	P AE L
PALACE	P AE L AH S
PALETTE	P AE L AH T
PALM	P AA M
PALM(2)	P AA L M
PAN	P AE N
PANCAKE	P AE N K EY K
PANE	P EY N
PANEL	P AE N AH L
PANIC	P AE N IH K
PANTS	P AE N T S
PAPER	P EY P ER
PAPERS	P EY P ER Z
PAPERWORK	P EY P ER W ER K
PAR	P AA R
PARACHUTE	P EH R AH SH UW T
PARADE	P ER EY D
PARADED	P ER EY D IH D
PARADIGM	P EH R AH D AY M
PARADISE	P EH R AH D AY S
PARAGRAPH	P AE R AH G R AE F
PARAGRAPH(2)	P EH R AH G R AE F
PARAKEET	P EH R AH K IY T
PARALEGAL	P EH R AH L IY G AH L
PARAMETER	P ER AE M AH T ER
PARAMILITARY	P EH R AH M IH L AH T EH R IY
PARAPHERNALIA	P EH R AH F AH N EY L Y AH
PARENT	P EH R AH N T
PARENTHESES	P ER EH N TH AH S IY Z
PARIAH	P ER AY AH
PARISHIONER	P ER IH SH AH N ER
PARK	P AA R K
PARKING	P AA R K IH NG
PARLIAMENT	P AA R L AH M EH N T
PARODY	P EH R AH D IY
PAROLE	P ER OW L
PARROT	P EH R AH T
PART	P AA R T
PARTICIPANT	P AA R T IH S AH P AH N T
PARTICIPATION	P AA R T IH S AH P EY SH AH N
PARTITION	P AA R T IH SH AH N
PARTNER	P AA R T N ER
PARTNERSHIP	P AA R T N ER SH IH P
PARTY	P AA R T IY
PASS	P AE S
PASSENGER	P AE S AH N JH ER
PASSING	P AE S IH NG
PASSION	P AE SH AH N
PASSPORT	P AE S P AO R T
PASSWORD	P AE S W ER D
PAST	P AE S T
PASTA	P AA S T AH
PASTE	P EY S T
PASTOR	P AE S T ER
PASTRY	P EY S T R IY
PASTURE	P AE S CH ER
PAT	P AE T
PATENT	P AE T AH N T
PATH	P AE TH
PATHOGEN	P AE TH AH JH AH N
PATIENCE	P EY SH AH N S
PATIENT	P EY SH AH N T
PATIENTS	P EY SH AH N T S
PATIENTS(2)	P EY SH AH N Z
PATIO	P AE T IY OW
PATROL	P AH T R OW L
PATRON	P EY T R AH N
PATRONAGE	P AE T R AH N IH JH
PATRONAGE(2)	P EY T R AH N AH JH
PATRONAGE(3)	P EY T R AH N IH JH
PATTERN	P AE T ER N
PATTY	P AE T IY
PAW	P AO
PAYER	P EY ER
PAYMENT	P EY M AH N T
PAYOFF	P EY AO F
PEA	P IY
PEACE	P IY S
PEACEKEEPING	P IY S K IY P IH NG
PEAK	P IY K
PEANUT	P IY N AH T
PEASANT	P EH Z AH N T
PEDANTRY	P EH D AH N T R IY
PEDDLE	P EH D AH L
PEDESTAL	P EH D AH S T AH L
PEDICURE	P EH D IH K Y ER
PEDICURE(2)	P EH D IH K Y AO R
PEEL	P IY L
PEER	P IH R
PEN	P EH N
PENALTY	P EH N AH L T IY
PENCIL	P EH N S AH L
PENDING	P EH N D IH NG
PENDULUM	P EH N JH AH L AH M
PENINSULA	P AH N IH N S AH L AH
PENNY	P EH N IY
PEOPLE	P IY P AH L
PEP	P EH P
PEPPER	P EH P ER
PEPPERONI	P EH P ER OW N IY
PER	P ER
PERCENT	P ER S EH N T
PERCENTAGE	P ER S EH N T AH JH
PERCENTAGE(2)	P ER S EH N AH JH
PERCENTAGE(3)	P ER S EH N T IH JH
PERCENTAGE(4)	P ER S EH N IH JH
PERCEPTION	P ER S EH P SH AH N
PERFECTION	P ER F EH K SH AH N
PERFECTIONIST	P ER F EH K SH AH N AH S T
PERFECTIONIST(2)	P ER F EH K SH AH N IH S T
PERFORMANCE	P ER F AO R M AH N S
PERFORMER	P ER F AO R M ER
PERFUME	P ER F Y UW M
PERIL	P EH R AH L
PERIOD	P IH R IY AH D
PERMISSION	P ER M IH SH AH N
PERMIT	P ER M IH T
PERSEVERANCE	P ER S AH V IH R AH N S
PERSON	P ER S AH N
PERSONALITY	P ER S AH N AE L IH T IY
PERSPECTIVE	P ER S P EH K T IH V
PERSUASION	P ER S W EY ZH AH N
PESTICIDE	P EH S T AH S AY D
PET	P EH T
PETARD	P EH T ER D
PETARD(2)	P AH T AA D
PETITION	P AH T IH SH AH N
PETROL	P EH T R OW L
PETROLEUM	P AH T R OW L IY AH M
PETTING	P EH T IH NG
PEWTER	P Y UW T ER
PHANTOM	F AE N T AH M
PHANTOM(2)	F AE N AH M
PHARMACY	F AA R M AH S IY
PHASE	F EY Z
PHENOMENON	F AH N AA M AH N AA N
PHILOSOPHY	F AH L AA S AH F IY
PHLOX	F L AA K S
PHOBIA	F OW B IY AH
PHOEBE	F IY B IY
PHONE	F OW N
PHONY	F OW N IY
PHOTO	F OW T OW
PHOTOGRAPH	F OW T AH G R AE F
PHOTOGRAPHER	F AH T AA G R AH F ER
PHOTOGRAPHY	F AH T AA G R AH F IY
PHRASE	F R EY Z
PHYSICAL	F IH Z IH K AH L
PHYSICIAN	F AH Z IH SH AH N
PHYSIOTHERAPIST	F IH S IY AH TH EH R AH P AH S T
PICK	P IH K
PICKET	P IH K IH T
PICKETING	P IH K AH T IH NG
PICKUP	P IH K AH P
PICTURE	P IH K CH ER
PIE	P AY
PIECE	P IY S
PIG	P IH G
PIGEON	P IH JH AH N
PIGEON(2)	P IH JH IH N
PILE	P AY L
PILLAR	P IH L ER
PILLOW	P IH L OW
PILOT	P AY L AH T
PIN	P IH N
PINE	P AY N
PINKIE	P IH NG K IY
PINKY	P IH NG K IY
PINT	P AY N T
PIONEER	P AY AH N IH R
PIPE	P AY P
PIPELINE	P AY P L AY N
PIPING	P AY P IH NG
PIRATE	P AY R AH T
PIT	P IH T
PITCH	P IH CH
PITFALL	P IH T F AO L
PIXEL	P IH K S AH L
PIZZA	P IY T S AH
PLACE	P L EY S
PLAGUE	P L EY G
PLAIN	P L EY N
PLAN	P L AE N
PLANE	P L EY N
PLANET	P L AE N AH T
PLANNER	P L AE N ER
PLANNING	P L AE N IH NG
PLANT	P L AE N T
PLANTAIN	P L AE N T AH N
PLASTER	P L AE S T ER
PLASTIC	P L AE S T IH K
PLATE	P L EY T
PLATFORM	P L AE T F AO R M
PLATTER	P L AE T ER
PLAY	P L EY
PLAYER	P L EY ER
PLAYING	P L EY IH NG
PLEADING	P L IY D IH NG
PLEASURE	P L EH ZH ER
PLEDGE	P L EH JH
PLENTY	P L EH N T IY
PLENTY(2)	P L EH N IY
PLIGHT	P L AY T
PLOT	P L AA T
PLOTTER	P L AA T ER
PLOVER	P L AH V ER
PLUG	P L AH G
PLUMBER	P L AH M ER
PLUNGE	P L AH N JH
PLUS	P L AH S
PLYWOOD	P L AY W UH D
POCKET	P AA K AH T
PODIUM	P OW D IY AH M
POET	P OW AH T
POINT	P OY N T
POISON	P OY Z AH N
POISONING	P OY Z AH N IH NG
POKER	P OW K ER
POLE	P OW L
POLICE	P AH L IY S
POLICEMAN	P AH L IY S M AH N
POLICY	P AA L AH S IY
POLISH	P AA L IH SH
POLISH(2)	P OW L IH SH
POLITE	P AH L AY T
POLITICIAN	P AA L AH T IH SH AH N
POLITICS	P AA L AH T IH K S
POLL	P OW L
POLLUTER	P AH L UW T ER
POLLUTION	P AH L UW SH AH N
POLYGAMY	P AH L IH G AH M IY
PONY	P OW N IY
POOL	P UW L
POOP	P UW P
POOR	P UW R
POP	P AA P
POPCORN	P AA P K AO R N
POPE	P OW P
POPULARITY	P AA P Y AH L EH R AH T IY
POPULATION	P AA P Y AH L EY SH AH N
POPULOUS	P AA P Y AH L AH S
PORCH	P AO R CH
PORK	P AO R K
PORT	P AO R T
PORTION	P AO R SH AH N
POSE	P OW Z
POSITION	P AH Z IH SH AH N
POSSIBILITY	P AA S AH B IH L AH T IY
POST	P OW S T
POSTAGE	P OW S T AH JH
POSTAGE(2)	P OW S T IH JH
POSTCARD	P OW S T K AA R D
POSTCARD(2)	P OW S K AA R D
POSTER	P OW S T ER
POSTERITY	P AA S T EH R AH T IY
POSTING	P OW S T IH NG
POSTPONEMENT	P OW S T P OW N M AH N T
POSTURE	P AA S CH ER
POT	P AA T
POTATO	P AH T EY T OW
POTENTIAL	P AH T EH N SH AH L
POTENTIALITY	P AH T EH N CH IY AE L AH T IY
POTPOURRI	P OW P UH R IY
POTTY	P AA T IY
POUCH	P AW CH
POUND	P AW N D
POVERTY	P AA V ER T IY
POWDER	P AW D ER
POWER	P AW ER
PRACTICE	P R AE K T IH S
PRAISE	P R EY Z
PRAWN	P R AO N
PRAYER	P R EH R
PRAYER(2)	P R EY ER
PREACHER	P R IY CH ER
PREAMBLE	P R IY AE M B AH L
PRECAUTION	P R IY K AO SH AH N
PRECONCEPTION	P R IY K AH N S EH P SH AH N
PREDATOR	P R EH D AH T ER
PREDICTION	P R IY D IH K SH AH N
PREDISPOSITION	P R IY D IH S P AH Z IH SH AH N
PREFERENCE	P R EH F ER AH N S
PREFERENCE(2)	P R EH F R AH N S
PREGNANCY	P R EH G N AH N S IY
PREJUDICE	P R EH JH AH D IH S
PRELUDE	P R EY L UW D
PREMISE	P R EH M IH S
PREMIUM	P R IY M IY AH M
PREPARATION	P R EH P ER EY SH AH N
PREPAREDNESS	P R IY P EH R AH D N AH S
PREPAYMENT	P R IY P EY M AH N T
PRESCHOOLER	P R IY S K UW L ER
PRESENCE	P R EH Z AH N S
PRESENT	P R EH Z AH N T
PRESENT(2)	P R IY Z EH N T
PRESENT(3)	P ER Z EH N T
PRESENTATION	P R EH Z AH N T EY SH AH N
PRESIDENT	P R EH Z IH D AH N T
PRESS	P R EH S
PRESSURE	P R EH SH ER
PRETENSE	P R IY T EH N S
PRETEXT	P R IY T EH K S T
PRETZEL	P R EH T Z AH L
PREVIEW	P R IY V Y UW
PREY	P R EY
PRICE	P R AY S
PRICING	P R AY S IH NG
PRIDE	P R AY D
PRIEST	P R IY S T
PRIMARY	P R AY M EH R IY
PRINCESS	P R IH N S EH S
PRINCIPAL	P R IH N S AH P AH L
PRINCIPLE	P R IH N S AH P AH L
PRINTER	P R IH N T ER
PRINTER(2)	P R IH N ER
PRINTING	P R IH N T IH NG
PRINTING(2)	P R IH N IH NG
PRIORITY	P R AY AO R AH T IY
PRISON	P R IH Z AH N
PRISONER	P R IH Z AH N ER
PRISONER(2)	P R IH Z N ER
PRIVACY	P R AY V AH S IY
PRIVILEGE	P R IH V IH L IH JH
PRIZE	P R AY Z
PRO	P R OW
PROBABILITY	P R AA B AH B IH L AH T IY
PROBATION	P R OW B EY SH AH N
PROBE	P R OW B
PROBLEM	P R AA B L AH M
PROCEDURE	P R AH S IY JH ER
PROCEDURE(2)	P R OW S IY JH ER
PROCEEDING	P R AH S IY D IH NG
PROCEEDING(2)	P R OW S IY D IH NG
PROCEEDINGS	P R OW S IY D IH NG Z
PROCEEDINGS(2)	P R AH S IY D IH NG Z
PROCESS	P R AA S EH S
PROCESS(2)	P R AO S EH S
PROCESSING	P R AA S EH S IH NG
PROCESSOR	P R AA S EH S ER
PROCUREMENT	P R OW K Y UH R M AH N T
PROD	P R AA D
PRODUCER	P R AH D UW S ER
PRODUCT	P R AA D AH K T
PRODUCTION	P R AH D AH K SH AH N
PRODUCTION(2)	P R OW D AH K SH AH N
PRODUCTION(3)	P ER D AH K SH AH N
PROFESSION	P R AH F EH SH AH N
PROFESSIONAL	P R AH F EH SH AH N AH L
PROFESSIONALISM	P R AH F EH SH AH N AH L IH Z AH M
PROFESSOR	P R AH F EH S ER
PROFICIENCY	P R AH F IH SH AH N S IY
PROFILE	P R OW F AY L
PROFIT	P R AA F AH T
PROFIT(2)	P R AA F IH T
PROGNOSIS	P R AA G N OW S AH S
PROGRAM	P R OW G R AE M
PROGRAMMING	P R OW G R AE M IH NG
PROGRESS	P R AA G R EH S
PROGRESS(2)	P R AH G R EH S
PROGRESS(3)	P R OW G R EH S
PROJECT	P R AA JH EH K T
PROLIFERATION	P R OW L IH F ER EY SH AH N
PROMISE	P R AA M AH S
PROMOTION	P R AH M OW SH AH N
PROMOTION(2)	P ER M OW SH AH N
PRONG	P R AO NG
PRONUNCIATION	P R OW N AH N S IY EY SH AH N
PRONUNCIATION(2)	P R AH N AH N S IY EY SH AH N
PROOF	P R UW F
PROPAGANDA	P R AA P AH G AE N D AH
PROPANE	P R OW P EY N
PROPERTY	P R AA P ER T IY
PROPONENT	P R AH P OW N AH N T
PROPORTION	P R AH P AO R SH AH N
PROPOSAL	P R AH P OW Z AH L
PROPOSITION	P R AA P AH Z IH SH AH N
PROPRIETOR	P R AH P R AY AH T ER
PROSECUTION	P R AA S AH K Y UW SH AH N
PROSECUTOR	P R AA S IH K Y UW T ER
PROSPECT	P R AA S P EH K T
PROSPERITY	P R AA S P EH R AH T IY
PROSTITUTE	P R AA S T AH T UW T
PROTECTION	P R AH T EH K SH AH N
PROTEIN	P R OW T IY N
PROTEST	P R OW T EH S T
PROTEST(2)	P R AH T EH S T
PROTOCOL	P R OW T AH K AA L
PROTOCOL(2)	P R OW T AH K AO L
PROVIDER	P R AH V AY D ER
PROVINCE	P R AA V AH N S
PROVINCE(2)	P R AA V IH N S
PROVISION	P R AH V IH ZH AH N
PROVISO	P R AH V AY Z OW
PROVOCATION	P R AA V AH K EY SH AH N
PRY	P R AY
PSEUDONYM	S UW D AH N IH M
PSYCHIATRIST	S AH K AY AH T R AH S T
PSYCHOLOGY	S AY K AA L AH JH IY
PUB	P AH B
PUBLIC	P AH B L IH K
PUBLICATION	P AH B L IH K EY SH AH N
PUBLISHER	P AH B L IH SH ER
PUFF	P AH F
PUFFING	P AH F IH NG
PULL	P UH L
PULLBACK	P UH L B AE K
PULLER	P UH L ER
PULSE	P AH L S
PUMP	P AH M P
PUMPKIN	P AH M P K IH N
PUMPKIN(2)	P AH M K IH N
PUNCH	P AH N CH
PUNCTUATION	P AH NG K CH UW EY SH AH N
PUNISHMENT	P AH N IH SH M AH N T
PUNK	P AH NG K
PUP	P AH P
PUPPET	P AH P AH T
PUPPET(2)	P AH P IH T
PUPPY	P AH P IY
PURCHASE	P ER CH AH S
PURPOSE	P ER P AH S
PURSE	P ER S
PURSUIT	P ER S UW T
PUSH	P UH SH
PUT	P UH T
PYRAMID	P IH R AH M IH D
PYTHON	P AY TH AA N
QUAD	K W AA D
QUALIFICATION	K W AA L AH F AH K EY SH AH N
QUALITY	K W AA L AH T IY
QUANTITY	K W AA N T AH T IY
QUARTER	K W AO R T ER
QUEEN	K W IY N
QUERY	K W IY R IY
QUEST	K W EH S T
QUESTION	K W EH S CH AH N
QUESTION(2)	K W EH SH AH N
QUIET	K W AY AH T
QUIETNESS	K W AY AH T N AH S
QUIZ	K W IH Z
QUOTE	K W OW T
RABBIT	R AE B AH T
RABBIT(2)	R AE B IH T
RABBLE	R AE B AH L
RACE	R EY S
RACING	R EY S IH NG
RACISM	R EY S IH Z AH M
RACK	R AE K
RADAR	R EY D AA R
RADIATION	R EY D IY EY SH AH N
RADICAL	R AE D IH K AH L
RADIO	R EY D IY OW
RAFFLE	R AE F AH L
RAGE	R EY JH
RAIL	R EY L
RAILWAY	R EY L W EY
RAIN	R EY N
RAINBOW	R EY N B OW
RAISING	R EY Z IH NG
RALLY	R AE L IY
RALLYING	R AE L IY IH NG
RAMIFICATION	R AE M AH F AH K EY SH AH N
RANCH	R AE N CH
RANCHER	R AE N CH ER
RANGE	R EY N JH
RANGER	R EY N JH ER
RANK	R AE NG K
RAPE	R EY P
RAT	R AE T
RATE	R EY T
RATING	R EY T IH NG
RATION	R AE SH AH N
RATION(2)	R EY SH AH N
RATTLING	R AE T L IH NG
RATTLING(2)	R AE T AH L IH NG
RAY	R EY
REACH	R IY CH
REACTION	R IY AE K SH AH N
REACTOR	R IY AE K T ER
READ	R EH D
READ(2)	R IY D
READER	R IY D ER
READING	R IY D IH NG
READING(2)	R EH D IH NG
REALIST	R IY AH L IH S T
REALITY	R IY AE L AH T IY
REALM	R EH L M
REAR	R IH R
REASON	R IY Z AH N
REASSURANCE	R IY AH SH UH R AH N S
REBEL	R EH B AH L
REBEL(2)	R IH B EH L
REBELLION	R IH B EH L Y AH N
REBIRTH	R IY B ER TH
RECALL	R IY K AO L
RECALL(2)	R IH K AO L
RECEIPT	R IH S IY T
RECEIPT(2)	R IY S IY T
RECEIVER	R AH S IY V ER
RECEIVER(2)	R IH S IY V ER
RECEIVER(3)	R IY S IY V ER
RECEPTION	R IH S EH P SH AH N
RECEPTION(2)	R IY S EH P SH AH N
RECEPTIONIST	R IH S EH P SH AH N IH S T
RECEPTIONIST(2)	R IY S EH P SH AH N IH S T
RECESSION	R IH S EH SH AH N
RECESSION(2)	R IY S EH SH AH N
RECIPE	R EH S AH P IY
RECIPIENT	R AH S IH P IY AH N T
RECIPIENT(2)	R IH S IH P IY AH N T
RECOGNITION	R EH K AH G N IH SH AH N
RECOGNITION(2)	R EH K IH G N IH SH AH N
RECOIL	R IY K OY L
RECOMMENDATION	R EH K AH M AH N D EY SH AH N
RECONCILIATION	R EH K AH N S IH L IY EY SH AH N
RECONCILING	R EH K AH N S AY L IH NG
RECONNAISSANCE	R IY K AA N AH S AH N S
RECONSTRUCTION	R IY K AH N S T R AH K SH AH N
RECORD	R AH K AO R D
RECORD(2)	R EH K ER D
RECORD(3)	R IH K AO R D
RECORDING	R AH K AO R D IH NG
RECORDING(2)	R IH K AO R D IH NG
RECOUNT	R IH K AW N T
RECOUNT(2)	R IY K AW N T
RECOVERY	R IH K AH V R IY
RECOVERY(2)	R IH K AH V ER IY
RECRUIT	R AH K R UW T
RECRUIT(2)	R IH K R UW T
RECRUIT(3)	R IY K R UW T
RECRUITING	R AH K R UW T IH NG
RECRUITING(2)	R IH K R UW T IH NG
RECRUITING(3)	R IY K R UW T IH NG
RECRUITMENT	R AH K R UW T M AH N T
RECRUITMENT(2)	R IH K R UW T M AH N T
RECRUITMENT(3)	R IY K R UW T M AH N T
RECTANGLE	R EH K T AE NG G AH L
RECTOR	R EH K T ER
RED	R EH D
REDUCTION	R IH D AH K SH AH N
REDWOOD	R EH D W UH D
REEF	R IY F
REFERENCE	R EH F ER AH N S
REFERENCE(2)	R EH F R AH N S
REFERRAL	R IH F ER AH L
REFINERY	R IH F AY N ER IY
REFLECTION	R AH F L EH K SH AH N
REFLECTION(2)	R IH F L EH K SH AH N
REFLECTOR	R IH F L EH K T ER
REFORMER	R IH F AO R M ER
REFRESHMENT	R AH F R EH SH M AH N T
REFRIGERATOR	R AH F R IH JH ER EY T ER
REFRIGERATOR(2)	R IH F R IH JH ER EY T ER
REFUGEE	R EH F Y UW JH IY
REFUND	R IH F AH N D
REFUND(2)	R IY F AH N D
REGARD	R AH G AA R D
REGARD(2)	R IH G AA R D
REGARDS	R IH G AA R D Z
REGIME	R AH ZH IY M
REGIME(2)	R EY ZH IY M
REGIMEN	R EH JH AH M AH N
REGION	R IY JH AH N
REGISTRAR	R EH JH IH S T R AA R
REGISTRATION	R EH JH IH S T R EY SH AH N
REGRET	R AH G R EH T
REGRET(2)	R IH G R EH T
REGULAR	R EH G Y AH L ER
REGULAR(2)	R EY G Y AH L ER
REGULARITY	R EH G Y AH L EH R AH T IY
REGULATION	R EH G Y AH L EY SH AH N
REGULATOR	R EH G Y AH L EY T ER
REIN	R EY N
REITERATION	R IY IH T ER EY SH AH N
REJECTION	R IH JH EH K SH AH N
REJECTION(2)	R IY JH EH K SH AH N
RELAPSE	R IY L AE P S
RELATION	R IY L EY SH AH N
RELATIONSHIP	R IY L EY SH AH N SH IH P
RELATIVE	R EH L AH T IH V
RELAXATION	R IY L AE K S EY SH AH N
RELEASE	R IY L IY S
RELIABILITY	R IY L AY AH B IH L AH T IY
RELIANCE	R IH L AY AH N S
RELIANCE(2)	R IY L AY AH N S
RELIEF	R IH L IY F
RELIEF(2)	R IY L IY F
RELIGION	R IH L IH JH AH N
RELIGION(2)	R IY L IH JH AH N
REMAINDER	R IH M EY N D ER
REMAINDER(2)	R IY M EY N D ER
REMAINS	R IH M EY N Z
REMAINS(2)	R IY M EY N Z
REMARK	R IH M AA R K
REMARK(2)	R IY M AA R K
REMEDIES	R EH M AH D IY Z
REMEDY	R EH M AH D IY
REMINDER	R IY M AY N D ER
REMISSION	R IY M IH SH AH N
REMNANT	R EH M N AH N T
REMODEL	R IY M AA D AH L
REMODELING	R IH M AA D AH L IH NG
REMODELING(2)	R IH M AA D L IH NG
REMOVAL	R IH M UW V AH L
RENEWAL	R IH N UW AH L
RENOVATION	R EH N AH V EY SH AH N
RENT	R EH N T
RENTAL	R EH N T AH L
REOPENING	R IY OW P AH N IH NG
REP	R EH P
REP(2)	R EH P R IY Z EH T AH T IH V
REPAIR	R IH P EH R
REPERCUSSION	R IY P ER K AH SH AH N
REPERCUSSION(2)	R IY P R AH K AH SH AH N
REPLACEMENT	R IH P L EY S M AH N T
REPLICA	R EH P L IH K AH
REPLY	R IH P L AY
REPLY(2)	R IY P L AY
REPORT	R IY P AO R T
REPORT(2)	R IH P AO R T
REPORTER	R IH P AO R T ER
REPORTING	R IY P AO R T IH NG
REPORTING(2)	R IH P AO R T IH NG
REPRESENTATION	R EH P R AH Z EH N T EY SH AH N
REPRESENTATIVE	R EH P R AH Z EH N T AH T IH V
REPRESENTATIVE(2)	R EH P R IH Z EH N T AH T IH V
REPRESENTATIVE(3)	R EH P R AH Z EH N AH T IH V
REPRESENTATIVE(4)	R EH P R IH Z EH N AH T IH V
REPRISAL	R IY P R AY Z AH L
REPTILE	R EH P T AY L
REPUBLIC	R IY P AH B L AH K
REPUBLIC(2)	R IY P AH B L IH K
REPUTATION	R EH P Y AH T EY SH AH N
REQUEST	R IH K W EH S T
REQUEST(2)	R IY K W EH S T
REQUIREMENT	R IH K W AY R M AH N T
RESCUE	R EH S K Y UW
RESCUER	R EH S K Y UW ER
RESEARCH	R IY S ER CH
RESEARCHER	R IY S ER CH ER
RESEMBLANCE	R IH Z EH M B L AH N S
RESEMBLANCE(2)	R IY Z EH M B L AH N S
RESERVATION	R EH Z ER V EY SH AH N
RESERVE	R IH Z ER V
RESERVE(2)	R IY Z ER V
RESERVOIR	R EH Z AH V W AA R
RESERVOIR(2)	R EH Z ER V W AA R
RESIDENCE	R EH Z IH D AH N S
RESIDENCY	R EH Z IH D AH N S IY
RESIDENT	R EH Z IH D AH N T
RESISTANCE	R IH Z IH S T AH N S
RESISTANCE(2)	R IY Z IH S T AH N S
RESOLUTION	R EH Z AH L UW SH AH N
RESORT	R IH Z AO R T
RESORT(2)	R IY Z AO R T
RESORT(3)	R IY S AO R T
RESOURCE	R IY S AO R S
RESPECT	R IH S P EH K T
RESPECT(2)	R IY S P EH K T
RESPECTS	R IH S P EH K T S
RESPECTS(2)	R IY S P EH K T S
RESPECTS(3)	R AH S P EH K S
RESPECTS(4)	R IY S P EH K S
RESPONDENT	R IH S P AA N D AH N T
RESPONSE	R IH S P AA N S
RESPONSE(2)	R IY S P AA N S
RESPONSIBILITY	R IY S P AA N S AH B IH L AH T IY
RESPONSIVENESS	R IH S P AA N S IH V N AH S
REST	R EH S T
RESTAURANT	R EH S T ER AA N T
RESTAURANT(2)	R EH S T R AA N T
RESTORATION	R EH S T ER EY SH AH N
RESTRICTION	R IY S T R IH K SH AH N
RESTRUCTURING	R IY S T R AH K CH ER IH NG
RESULT	R IH Z AH L T
RESULT(2)	R IY Z AH L T
RESUME	R IH Z UW M
RESUME(2)	R IY Z UW M
RESUME(3)	R EH Z AH M EY
RESUPPLY	R IY S AH P L AY
RETAIL	R IY T EY L
RETAILER	R IY T EY L ER
RETALIATION	R IY T AE L IY EY SH AH N
RETARDATION	R IY T AA R D EY SH AH N
RETENTION	R IY T EH N SH AH N
RETIREMENT	R IY T AY ER M AH N T
RETIREMENT(2)	R IH T AY ER M AH N T
RETREAT	R IY T R IY T
RETRIAL	R IY T R AY AH L
RETROSPECT	R EH T R AH S P EH K T
RETURN	R IH T ER N
RETURN(2)	R IY T ER N
RETURNEE	R IH T ER N IY
REVENGE	R IY V EH N JH
REVENUE	R EH V AH N UW
REVENUE(2)	R EH V AH N Y UW
REVERSAL	R IH V ER S AH L
REVERSAL(2)	R IY V ER S AH L
REVIEW	R IY V Y UW
REVIEWER	R IY V Y UW ER
REVIEWS	R IY V Y UW Z
REVIEWS(2)	R AH V Y UW Z
REVISION	R IY V IH ZH AH N
REVOCATION	R EH V AH K EY SH AH N
REVOLT	R IH V OW L T
REVOLT(2)	R IY V OW L T
REVOLUTION	R EH V AH L UW SH AH N
REWARD	R IH W AO R D
REWARD(2)	R IY W AO R D
RHYTHM	R IH DH AH M
RIB	R IH B
RIBBON	R IH B AH N
RICE	R AY S
RIDE	R AY D
RIDER	R AY D ER
RIDING	R AY D IH NG
RIFLE	R AY F AH L
RIFT	R IH F T
RIGHT	R AY T
RIGHTEOUSNESS	R AY CH AH S N AH S
RIGHTS	R AY T S
RING	R IH NG
RINGLEADER	R IH NG L IY D ER
RIP	R IH P
RISE	R AY Z
RISK	R IH S K
RIVALRY	R AY V AH L R IY
RIVER	R IH V ER
ROACH	R OW CH
ROAD	R OW D
ROADSIDE	R OW D S AY D
ROBBER	R AA B ER
ROBE	R OW B
ROBOT	R OW B AA T
ROBOT(2)	R OW B AH T
ROCK	R AA K
ROCKET	R AA K AH T
RODE	R OW D
RODENT	R OW D AH N T
ROGUE	R OW G
ROLE	R OW L
ROLL	R OW L
ROLLBACK	R OW L B AE K
ROMAINE	R OW M EY N
ROMANCE	R OW M AE N S
ROOF	R UW F
ROOF(2)	R UH F
ROOFING	R UW F IH NG
ROOM	R UW M
ROOMFUL	R UW M F UH L
ROOSTER	R UW S T ER
ROOT	R UW T
ROSE	R OW Z
ROSETTE	R AH S EH T
ROT	R AA T
ROTATION	R OW T EY SH AH N
ROUGHHOUSE	R AH F HH AW S
ROUND	R AW N D
ROUTE	R UW T
ROUTE(2)	R AW T
ROUTINE	R UW T IY N
ROW	R OW
RUBBER	R AH B ER
RUBBISH	R AH B IH SH
RUBBLE	R AH B AH L
RUDENESS	R UW D N AH S
RUG	R AH G
RULE	R UW L
RULER	R UW L ER
RULING	R UW L IH NG
RUMOR	R UW M ER
RUN	R AH N
RUNAROUND	R AH N AH R AW N D
RUNNER	R AH N ER
RUNNING	R AH N IH NG
RUT	R AH T
SABER	S EY B ER
SABOTEUR	S AE B AH T ER
SACKING	S AE K IH NG
SACRIFICE	S AE K R AH F AY S
SACRISTY	S AE K R IH S T IY
SADDLE	S AE D AH L
SAFEGUARD	S EY F G AA R D
SAFETY	S EY F T IY
SAGA	S AA G AH
SAILING	S EY L IH NG
SAILOR	S EY L ER
SAKE	S EY K
SALAD	S AE L AH D
SALARY	S AE L ER IY
SALE	S EY L
SALES	S EY L Z
SALESMAN	S EY L Z M AH N
SALESPEOPLE	S EY L Z P IY P AH L
SALESPERSON	S EY L Z P ER S AH N
SALMON	S AE M AH N
SALON	S AH L AA N
SALSA	S AA L S AH
SALT	S AO L T
SALVAGE	S AE L V AH JH
SALVAGE(2)	S AE L V IH JH
SAMPLE	S AE M P AH L
SAMPLER	S AE M P L ER
SAMPLING	S AE M P L IH NG
SANCTION	S AE NG K SH AH N
SANCTUARY	S AE NG K CH UW EH R IY
SAND	S AE N D
SANDALWOOD	S AE N D AH L W UH D
SANDBAG	S AE N D B AE G
SANDWICH	S AE N D W IH CH
SANDWICH(2)	S AE N W IH CH
SANDWICH(3)	S AE M W IH CH
SAP	S AE P
SAPLING	S AE P L IH NG
SATELLITE	S AE T AH L AY T
SATISFACTION	S AE T AH S F AE K SH AH N
SATISFACTION(2)	S AE T IH S F AE K SH AH N
SAUCE	S AO S
SAUSAGE	S AO S AH JH
SAUSAGE(2)	S AO S IH JH
SAVINGS	S EY V IH NG Z
SAVIOUR	S EY V Y ER
SAW	S AO
SAYING	S EY IH NG
SCALE	S K EY L
SCALLOP	S K AE L AH P
SCAM	S K AE M
SCAMPI	S K AE M P IY
SCANDAL	S K AE N D AH L
SCANNING	S K AE N IH NG
SCARE	S K EH R
SCENARIO	S IH N EH R IY OW
SCENE	S IY N
SCENERY	S IY N ER IY
SCENT	S EH N T
SCHEDULE	S K EH JH UH L
SCHEDULE(2)	S K EH JH UW L
SCHEDULED	S K EH JH UH L D
SCHEDULED(2)	S K EH JH UW L D
SCHEDULER	S K EH JH UH L ER
SCHEDULER(2)	S K EH JH UW L ER
SCHEDULING	S K EH JH UH L IH NG
SCHEDULING(2)	S K EH JH UW L IH NG
SCHEME	S K IY M
SCHOLAR	S K AA L ER
SCHOLARSHIP	S K AA L ER SH IH P
SCHOOL	S K UW L
SCHOOLING	S K UW L IH NG
SCHTICK	SH T IH K
SCIENCE	S AY AH N S
SCIENTIST	S AY AH N T IH S T
SCISSORS	S IH Z ER Z
SCOOP	S K UW P
SCOOPING	S K UW P IH NG
SCOPE	S K OW P
SCORE	S K AO R
SCORING	S K AO R IH NG
SCORN	S K AO R N
SCRAMBLE	S K R AE M B AH L
SCRAP	S K R AE P
SCRATCH	S K R AE CH
SCRATCHING	S K R AE CH IH NG
SCREAM	S K R IY M
SCREEN	S K R IY N
SCREW	S K R UW
SCRUFF	S K R AH F
SCRUTINY	S K R UW T AH N IY
SCULPTING	S K AH L P T IH NG
SCULPTURE	S K AH L P CH ER
SEA	S IY
SEAFOOD	S IY F UW D
SEAL	S IY L
SEAMSTRESS	S IY M S T R IH S
SEARCH	S ER CH
SEARCHING	S ER CH IH NG
SEAS	S IY Z
SEASON	S IY Z AH N
SEAT	S IY T
SEATING	S IY T IH NG
SECESSION	S IH S EH SH AH N
SECESSIONIST	S IH S EH SH AH N IH S T
SECLUSION	S IH K L UW ZH AH N
SECOND	S EH K AH N D
SECONDS	S EH K AH N D Z
SECRET	S IY K R AH T
SECRET(2)	S IY K R IH T
SECRETARY	S EH K R AH T EH R IY
SECRETION	S AH K R IY SH AH N
SECT	S EH K T
SECTION	S EH K SH AH N
SECTOR	S EH K T ER
SECURITY	S IH K Y UH R AH T IY
SEED	S IY D
SEEKER	S IY K ER
SEGMENT	S EH G M AH N T
SEGMENT(2)	S EH G M EH N T
SEIZURE	S IY ZH ER
SELECTION	S AH L EH K SH AH N
SELF	S EH L F
SELLER	S EH L ER
SEMESTER	S AH M EH S T ER
SEMICOLON	S EH M IY K OW L AH N
SENATE	S EH N AH T
SENATE(2)	S EH N IH T
SENATOR	S EH N AH T ER
SEND	S EH N D
SENDER	S EH N D ER
SENSATION	S EH N S EY SH AH N
SENSE	S EH N S
SENSITIVITY	S EH N S IH T IH V IH T IY
SENSOR	S EH N S ER
SENTENCE	S EH N T AH N S
SENTENCING	S EH N T AH N S IH NG
SENTIMENT	S EH N T AH M AH N T
SENTIMENT(2)	S EH N AH M AH N T
SEPARATION	S EH P ER EY SH AH N
SEPARATIST	S EH P ER AH T IH S T
SEQUENCE	S IY K W AH N S
SERGEANT	S AA R JH AH N T
SERIES	S IH R IY Z
SERIOUSNESS	S IH R IY AH S N AH S
SERPENT	S ER P AH N T
SERVANT	S ER V AH N T
SERVER	S ER V ER
SERVICE	S ER V AH S
SERVICE(2)	S ER V IH S
SERVING	S ER V IH NG
SESAME	S EH S AH M IY
SESSION	S EH SH AH N
SET	S EH T
SETBACK	S EH T B AE K
SETTING	S EH T IH NG
SETTLEMENT	S EH T AH L M AH N T
SETUP	S EH T AH P
SEWAGE	S UW AH JH
SEWAGE(2)	S UW IH JH
SEX	S EH K S
SHADE	SH EY D
SHADOW	SH AE D OW
SHAFT	SH AE F T
SHAM	SH AE M
SHAME	SH EY M
SHAMPOO	SH AE M P UW
SHANK	SH AE NG K
SHAPE	SH EY P
SHARE	SH EH R
SHARK	SH AA R K
SHAVE	SH EY V
SHED	SH EH D
SHEDDING	SH EH D IH NG
SHEEP	SH IY P
SHEET	SH IY T
SHEIK	SH IY K
SHEIKH	SH IY K
SHELF	SH EH L F
SHELL	SH EH L
SHELTER	SH EH L T ER
SHEPHERD	SH EH P ER D
SHERIFF	SH EH R AH F
SHERIFF(2)	SH EH R IH F
SHIELD	SH IY L D
SHIFT	SH IH F T
SHIFTING	SH IH F T IH NG
SHINE	SH AY N
SHIP	SH IH P
SHIPMENT	SH IH P M AH N T
SHIPPER	SH IH P ER
SHIPPING	SH IH P IH NG
SHIPYARD	SH IH P Y AA R D
SHIRT	SH ER T
SHIRTSLEEVE	SH ER T S L IY V
SHIT	SH IH T
SHOCK	SH AA K
SHOE	SH UW
SHOOT	SH UW T
SHOOTING	SH UW T IH NG
SHOP	SH AA P
SHOPPER	SH AA P ER
SHOPPING	SH AA P IH NG
SHORE	SH AO R
SHORTAGE	SH AO R T AH JH
SHORTAGE(2)	SH AO R T IH JH
SHOT	SH AA T
SHOTGUN	SH AA T G AH N
SHOULDER	SH OW L D ER
SHOVEL	SH AH V AH L
SHOW	SH OW
SHOWDOWN	SH OW D AW N
SHOWER	SH AW ER
SHOWROOM	SH OW R UH M
SHOWROOM(2)	SH OW R UW M
SHRAPNEL	SH R AE P N AH L
SHRED	SH R EH D
SHREWDNESS	SH R UW D N AH S
SHRIMP	SH R IH M P
SHRINE	SH R AY N
SHRINK	SH R IH NG K
SHRUB	SH R AH B
SHRUG	SH R AH G
SHUTTLE	SH AH T AH L
SICK	S IH K
SICKNESS	S IH K N AH S
SIDE	S AY D
SIDELINE	S AY D L AY N
SIEGE	S IY JH
SIGHT	S AY T
SIGN	S AY N
SIGNAL	S IH G N AH L
SIGNATORY	S IH G N AH T AO R IY
SIGNATURE	S IH G N AH CH ER
SIGNER	S AY N ER
SIGNING	S AY N IH NG
SILK	S IH L K
SILKY	S IH L K IY
SILVER	S IH L V ER
SILVERWARE	S IH L V ER W EH R
SIMILARITY	S IH M AH L EH R AH T IY
SIMPLIFICATION	S IH M P L AH F IH K EY SH AH N
SIMULATION	S IH M Y AH L EY SH AH N
SINGLE	S IH NG G AH L
SINGLES	S IH NG G AH L Z
SINK	S IH NG K
SINKING	S IH NG K IH NG
SIR	S ER
SIRLOIN	S ER L OY N
SISTER	S IH S T ER
SIT	S IH T
SITCOM	S IH T K AA M
SITE	S AY T
SITTING	S IH T IH NG
SITUATION	S IH CH UW EY SH AH N
SIXTH	S IH K S TH
SIXTY	S IH K S T IY
SIZE	S AY Z
SKATER	S K EY T ER
SKILL	S K IH L
SKIN	S K IH N
SKULL	S K AH L
SKY	S K AY
SKYLIGHT	S K AY L AY T
SLANG	S L AE NG
SLAT	S L AE T
SLAVE	S L EY V
SLAVERY	S L EY V ER IY
SLEEP	S L IY P
SLEEPER	S L IY P ER
SLEEPING	S L IY P IH NG
SLEEVE	S L IY V
SLICE	S L AY S
SLIDE	S L AY D
SLIP	S L IH P
SLIVER	S L IH V ER
SLOT	S L AA T
SLUM	S L AH M
SLUT	S L AH T
SMELL	S M EH L
SMILE	S M AY L
SMIRK	S M ER K
SMOKE	S M OW K
SMOKER	S M OW K ER
SMOKING	S M OW K IH NG
SMUGGLING	S M AH G L IH NG
SMUGGLING(2)	S M AH G AH L IH NG
SNACK	S N AE K
SNAFFLE	S N AE F AH L
SNAIL	S N EY L
SNAKE	S N EY K
SNAP	S N AE P
SNIPER	S N AY P ER
SNORKELING	S N AO R K AH L IH NG
SNOW	S N OW
SNOWBOARD	S N OW B AO R D
SNOWSTORM	S N OW S T AO R M
SNUB	S N AH B
SOAKING	S OW K IH NG
SOAP	S OW P
SOBRIQUET	S OW B R AH K EY
SOBRIQUET(2)	S OW B R AH K EH T
SOCCER	S AA K ER
SOCIALISM	S OW SH AH L IH Z AH M
SOCIALIZATION	S OW SH AH L IH Z EY SH AH N
SOCIETY	S OW S AY IH T IY
SODA	S OW D AH
SODIUM	S OW D IY AH M
SOFA	S OW F AH
SOFTENER	S AO F AH N ER
SOFTWARE	S AO F T W EH R
SOFTWARE(2)	S AO F W EH R
SOIL	S OY L
SOLDIER	S OW L JH ER
SOLEMNITY	S AH L EH M N AH T IY
SOLID	S AA L AH D
SOLIDARITY	S AA L AH D EH R AH T IY
SOLUTION	S AH L UW SH AH N
SOLVING	S AA L V IH NG
SOMEDAY	S AH M D EY
SOMEPLACE	S AH M P L EY S
SOMEWHERE	S AH M W EH R
SON	S AH N
SONG	S AO NG
SONNY	S AH N IY
SOPHOMORE	S AA F M AO R
SORT	S AO R T
SOUL	S OW L
SOUND	S AW N D
SOUP	S UW P
SOURCE	S AO R S
SOURCING	S AO R S IH NG
SOUTH	S AW TH
SOUTHEAST	S AW TH IY S T
SOUVENIR	S UW V AH N IH R
SOVEREIGNTY	S AA V R AH N T IY
SPA	S P AA
SPACE	S P EY S
SPACECRAFT	S P EY S K R AE F T
SPACEFLIGHT	S P EY S F L AY T
SPACEWALK	S P EY S W AA K
SPADEWORK	S P EY D W ER K
SPAGHETTI	S P AH G EH T IY
SPARE	S P EH R
SPAWNING	S P AA N IH NG
SPAWNING(2)	S P AO N IH NG
SPAY	S P EY
SPEAK	S P IY K
SPEAKER	S P IY K ER
SPECIAL	S P EH SH AH L
SPECIALIST	S P EH SH AH L IH S T
SPECIES	S P IY SH IY Z
SPECIFICATION	S P EH S IH F IH K EY SH AH N
SPECIFICS	S P IH S IH F IH K S
SPEECH	S P IY CH
SPEED	S P IY D
SPELLING	S P EH L IH NG
SPENDING	S P EH N D IH NG
SPHERE	S F IH R
SPICE	S P AY S
SPIEL	S P IY L
SPIKE	S P AY K
SPIN	S P IH N
SPINACH	S P IH N AH CH
SPINE	S P AY N
SPIRIT	S P IH R AH T
SPIRIT(2)	S P IH R IH T
SPIRITUALITY	S P IH R IH CH UW AE L AH T IY
SPITE	S P AY T
SPLASH	S P L AE SH
SPLIT	S P L IH T
SPOILAGE	S P OY L AH JH
SPOILAGE(2)	S P OY L IH JH
SPOKESMAN	S P OW K S M AH N
SPOKESPERSON	S P OW K S P ER S AH N
SPONGE	S P AH N JH
SPONSORSHIP	S P AA N S ER SH IH P
SPOON	S P UW N
SPORE	S P AO R
SPORT	S P AO R T
SPOT	S P AA T
SPOTLIGHT	S P AA T L AY T
SPOUSE	S P AW S
SPRAY	S P R EY
SPRAYING	S P R EY IH NG
SPREAD	S P R EH D
SPREADSHEET	S P R EH D SH IY T
SPREE	S P R IY
SPRING	S P R IH NG
SPRING(2)	S P ER IH NG
SPUR	S P ER
SPURT	S P ER T
SPY	S P AY
SPYING	S P AY IH NG
SQUADRON	S K W AA D R AH N
SQUARE	S K W EH R
SQUEAK	S K W IY K
STABILITY	S T AH B IH L IH T IY
STABILIZATION	S T EY B AH L AH Z EY SH AH N
STABLE	S T EY B AH L
STADIUM	S T EY D IY AH M
STAFF	S T AE F
STAFFS	S T AE F S
STAGE	S T EY JH
STAIN	S T EY N
STAIR	S T EH R
STAKE	S T EY K
STALL	S T AO L
STAMINA	S T AE M AH N AH
STAMP	S T AE M P
STAND	S T AE N D
STANDARD	S T AE N D ER D
STANDING	S T AE N D IH NG
STANDPOINT	S T AE N D P OY N T
STAPLE	S T EY P AH L
STAR	S T AA R
STARDOM	S T AA R D AH M
STARE	S T EH R
START	S T AA R T
STARTER	S T AA R T ER
STARTING	S T AA R T IH NG
STARVATION	S T AA R V EY SH AH N
STATE	S T EY T
STATEMENT	S T EY T M AH N T
STATIC	S T AE T IH K
STATION	S T EY SH AH N
STATIONERY	S T EY SH AH N EH R IY
STATUE	S T AE CH UW
STATURE	S T AE CH ER
STATUS	S T AE T AH S
STATUS(2)	S T EY T AH S
STAY	S T EY
STEAK	S T EY K
STEAKHOUSE	S T EY K HH AW S
STEAM	S T IY M
STEEL	S T IY L
STEER	S T IH R
STEERING	S T IH R IH NG
STEP	S T EH P
STEREO	S T EH R IY OW
STICK	S T IH K
STICKER	S T IH K ER
STINT	S T IH N T
STIPEND	S T AY P AH N D
STIPULATION	S T IH P Y AH L EY SH AH N
STIRRUP	S T ER AH P
STOCK	S T AA K
STOCKHOLDER	S T AA K HH OW L D ER
STOCKPILE	S T AA K P AY L
STOMACH	S T AH M AH K
STONE	S T OW N
STOOGE	S T UW JH
STOP	S T AA P
STORAGE	S T AO R AH JH
STORAGE(2)	S T AO R IH JH
STORE	S T AO R
STOREFRONT	S T AO R F R AA N T
STORM	S T AO R M
STORY	S T AO R IY
STOVE	S T OW V
STRAIN	S T R EY N
STRANGER	S T R EY N JH ER
STRATEGY	S T R AE T AH JH IY
STREAK	S T R IY K
STREAM	S T R IY M
STREET	S T R IY T
STRENGTH	S T R EH NG K TH
STRENGTH(2)	S T R EH NG TH
STRESS	S T R EH S
STRETCH	S T R EH CH
STRIDE	S T R AY D
STRIFE	S T R AY F
STRIKE	S T R AY K
STRING	S T R IH NG
STRIPE	S T R AY P
STRIPPER	S T R IH P ER
STROBE	S T R OW B
STROKE	S T R OW K
STRONGHOLD	S T R AO NG HH OW L D
STRUCTURE	S T R AH K CH ER
STRUCTURING	S T R AH K CH ER IH NG
STRUGGLE	S T R AH G AH L
STUB	S T AH B
STUDENT	S T UW D AH N T
STUDIO	S T UW D IY OW
STUDY	S T AH D IY
STUFF	S T AH F
STUPIDITY	S T UW P IH D IH T IY
STURDY	S T ER D IY
STYLE	S T AY L
STYLIST	S T AY L IH S T
SUB	S AH B
SUBCONTINENT	S AH B K AA N T IH N AH N T
SUBJECT	S AH B JH EH K T
SUBJECT(2)	S AH B JH IH K T
SUBMARINE	S AH B M ER IY N
SUBMISSION	S AH B M IH SH AH N
SUBPOENA	S AH P IY N AH
SUBSCRIPTION	S AH B S K R IH P SH AH N
SUBSIDIARY	S AH B S IH D IY EH R IY
SUBSIDY	S AH B S IH D IY
SUBSTANCE	S AH B S T AH N S
SUBSTANTIATION	S AH B S T AE N CH IY EY SH AH N
SUBSTANTIATION(2)	S AH B S T AE N SH IY EY SH AH N
SUBSTRATE	S AH B S T R EY T
SUBTERFUGE	S AH B T ER F Y UW JH
SUBURB	S AH B ER B
SUBWAY	S AH B W EY
SUCCESS	S AH K S EH S
SUCCESSOR	S AH K S EH S ER
SUFFERING	S AH F ER IH NG
SUFFERING(2)	S AH F R IH NG
SUFFIX	S AH F IH K S
SUGAR	SH UH G ER
SUGGESTION	S AH JH EH S CH AH N
SUICIDE	S UW AH S AY D
SUICIDE(2)	S UW IH S AY D
SUIT	S UW T
SUITCASE	S UW T K EY S
SUITE	S W IY T
SULFUR	S AH L F ER
SUM	S AH M
SUMMARY	S AH M ER IY
SUMMER	S AH M ER
SUMO	S UW M OW
SUMP	S AH M P
SUN	S AH N
SUNLIGHT	S AH N L AY T
SUPERIOR	S UW P IH R IY ER
SUPERIORITY	S UW P IH R IY AO R IH T IY
SUPERMARKET	S UW P ER M AA R K IH T
SUPERPOWER	S UW P ER P AW ER
SUPERVISOR	S UW P ER V AY Z ER
SUPPLEMENT	S AH P L AH M AH N T
SUPPLEMENT(2)	S AH P L AH M EH N T
SUPPLIER	S AH P L AY ER
SUPPLIES	S AH P L AY Z
SUPPLY	S AH P L AY
SUPPORT	S AH P AO R T
SUPPORTER	S AH P AO R T ER
SUPPOSITION	S AH P AH Z IH SH AH N
SUPREMACY	S AH P R EH M AH S IY
SURFACE	S ER F AH S
SURGE	S ER JH
SURGEON	S ER JH AH N
SURGEON(2)	S ER JH IH N
SURGERY	S ER JH ER IY
SURPLUS	S ER P L AH S
SURPRISE	S ER P R AY Z
SURPRISE(2)	S AH P R AY Z
SURRENDER	S ER EH N D ER
SURROUNDINGS	S ER AW N D IH NG Z
SURVEILLANCE	S ER V EY L AH N S
SURVEY	S ER V EY
SURVIVAL	S ER V AY V AH L
SURVIVOR	S ER V AY V ER
SUSHI	S UW SH IY
SUSPECT	S AH S P EH K T
SUSPENSION	S AH S P EH N SH AH N
SUSPICION	S AH S P IH SH AH N
SWALLOW	S W AA L OW
SWALLOW(2)	S W AO L OW
SWAP	S W AA P
SWEAT	S W EH T
SWEEPER	S W IY P ER
SWEET	S W IY T
SWING	S W IH NG
SWITCH	S W IH CH
SWITCHBOARD	S W IH CH B AO R D
SYMBOL	S IH M B AH L
SYMBOLISM	S IH M B AH L IH Z AH M
SYMPATHIZER	S IH M P AH TH AY Z ER
SYMPATHY	S IH M P AH TH IY
SYMPTOM	S IH M P T AH M
SYNCH	S IH N CH
SYNTHESIS	S IH N TH AH S AH S
SYSTEM	S IH S T AH M
TABLE	T EY B AH L
TABLET	T AE B L AH T
TABS	T AE B Z
TACO	T AA K OW
TACTIC	T AE K T IH K
TAG	T AE G
TAIL	T EY L
TAKE	T EY K
TAKEOVER	T EY K OW V ER
TAKING	T EY K IH NG
TALE	T EY L
TALENT	T AE L AH N T
TALK	T AO K
TALKING	T AO K IH NG
TANDEM	T AE N D AH M
TANK	T AE NG K
TANKER	T AE NG K ER
TAP	T AE P
TAPE	T EY P
TARGET	T AA R G AH T
TARGET(2)	T ER G AH T
TARIFF	T EH R AH F
TASK	T AE S K
TASKING	T AE S K IH NG
TASTE	T EY S T
TASTING	T EY S T IH NG
TATTOO	T AE T UW
TAVERN	T AE V ER N
TAX	T AE K S
TAXI	T AE K S IY
TAXPAYER	T AE K S P EY ER
TEA	T IY
TEACHER	T IY CH ER
TEACHING	T IY CH IH NG
TEAM	T IY M
TECHNICIAN	T EH K N IH SH AH N
TECHNIQUE	T EH K N IY K
TECHNOLOGY	T EH K N AA L AH JH IY
TEE	T IY
TEEN	T IY N
TEENAGER	T IY N EY JH ER
TEENS	T IY N Z
TEETH	T IY TH
TELEPHONE	T EH L AH F OW N
TELEPHONY	T EH L AH F OW N IY
TELEVISION	T EH L AH V IH ZH AH N
TEMP	T EH M P
TEMPER	T EH M P ER
TEMPERAMENT	T EH M P R AH M AH N T
TEMPERAMENT(2)	T EH M P ER M AH N T
TEMPERANCE	T EH M P ER AH N S
TEMPERANCE(2)	T EH M P R AH N S
TEMPERATURE	T EH M P R AH CH ER
TEMPERATURE(2)	T EH M P ER AH CH ER
TEMPLE	T EH M P AH L
TEMPURA	T EH M P Y AH R AH
TEN	T EH N
TENACITY	T AH N AE S IH T IY
TENANT	T EH N AH N T
TENDENCY	T EH N D AH N S IY
TENNIS	T EH N AH S
TENNIS(2)	T EH N IH S
TENSION	T EH N SH AH N
TENT	T EH N T
TENTH	T EH N TH
TERM	T ER M
TERMINAL	T ER M AH N AH L
TERMINATION	T ER M AH N EY SH AH N
TERRITORY	T EH R IH T AO R IY
TERROR	T EH R ER
TERRORISM	T EH R AH R IH Z AH M
TERRORIST	T EH R AH R IH S T
TEST	T EH S T
TESTAMENT	T EH S T AH M AH N T
TESTIMONY	T EH S T IH M OW N IY
TESTING	T EH S T IH NG
TESTOSTERONE	T EH S T AA S T ER OW N
TEXT	T EH K S T
TEXTURE	T EH K S CH ER
THANK	TH AE NG K
THANKS	TH AE NG K S
THAWED	TH AO D
THEATER	TH IY EY T ER
THEATRE	TH IY AH T ER
THEFT	TH EH F T
THEME	TH IY M
THEORY	TH IH R IY
THEORY(2)	TH IY ER IY
THERAPIST	TH EH R AH P IH S T
THERAPY	TH EH R AH P IY
THERMOMETER	TH ER M AA M AH T ER
THESIS	TH IY S IH S
THICKNESS	TH IH K N AH S
THIEF	TH IY F
THIEVERY	TH IY V ER IY
THIGH	TH AY
THING	TH IH NG
THINK	TH IH NG K
THINKING	TH IH NG K IH NG
THIRD	TH ER D
THIRST	TH ER S T
THIS	DH IH S
THOUGHT	TH AO T
THOUSAND	TH AW Z AH N D
THOUSAND(2)	TH AW Z AH N
THREAD	TH R EH D
THREAT	TH R EH T
THREATENED	TH R EH T AH N D
THRESHOLD	TH R EH SH OW L D
THROAT	TH R OW T
THUG	TH AH G
THUMB	TH AH M
THYROID	TH AY R OY D
TICKET	T IH K AH T
TICKET(2)	T IH K IH T
TIDBIT	T IH D B IH T
TIDE	T AY D
TIE	T AY
TILE	T AY L
TIMBER	T IH M B ER
TIME	T AY M
TIMER	T AY M ER
TIMETABLE	T AY M T EY B AH L
TIMING	T AY M IH NG
TIN	T IH N
TINT	T IH N T
TIP	T IH P
TIRE	T AY ER
TISSUE	T IH S Y UW
TISSUE(2)	T IH SH UW
TITLE	T AY T AH L
TOAST	T OW S T
TODAY	T AH D EY
TODAY(2)	T UW D EY
TODDLER	T AA D L ER
TOE	T OW
TOENAIL	T OW N EY L
TOFU	T OW F UW
TOILET	T OY L AH T
TOLL	T OW L
TOM	T AA M
TOMATO	T AH M EY T OW
TOMATO(2)	T AH M AA T OW
TOMORROW	T AH M AA R OW
TOMORROW(2)	T UW M AA R OW
TON	T AH N
TONGUE	T AH NG
TONIGHT	T AH N AY T
TONIGHT(2)	T UW N AY T
TONNAGE	T AH N AH JH
TONNAGE(2)	T AH N IH JH
TONNE	T AH N
TOOL	T UW L
TOOLING	T UW L IH NG
TOOTH	T UW TH
TOOTHACHE	T UW TH EY K
TOP	T AA P
TOP(2)	T AO P
TOPIC	T AA P IH K
TORCH	T AO R CH
TORTILLA	T AO R T IY AH
TORTURE	T AO R CH ER
TOTAL	T OW T AH L
TOTE	T OW T
TOUCH	T AH CH
TOUR	T UH R
TOURISM	T UH R IH Z AH M
TOURIST	T UH R AH S T
TOURIST(2)	T UH R IH S T
TOURNAMENT	T UH R N AH M AH N T
TOW	T OW
TOWEL	T AW AH L
TOWEL(2)	T AW L
TOWER	T AW ER
TOWING	T OW IH NG
TOWN	T AW N
TOWNHOUSE	T AW N HH AW S
TOWNSHIP	T AW N SH IH P
TOXIN	T AA K S AH N
TOY	T OY
TRACE	T R EY S
TRACK	T R AE K
TRACKING	T R AE K IH NG
TRACT	T R AE K T
TRACTOR	T R AE K T ER
TRADE	T R EY D
TRADEMARK	T R EY D M AA R K
TRADEMARKING	T R EY D M AA R K IH NG
TRADER	T R EY D ER
TRADING	T R EY D IH NG
TRADITION	T R AH D IH SH AH N
TRAFFIC	T R AE F IH K
TRAFFICKER	T R AE F IH K ER
TRAFFICKING	T R AE F IH K IH NG
TRAGEDY	T R AE JH AH D IY
TRAIL	T R EY L
TRAILER	T R EY L ER
TRAIN	T R EY N
TRAINER	T R EY N ER
TRAINING	T R EY N IH NG
TRAITOR	T R EY T ER
TRANSACTION	T R AE N Z AE K SH AH N
TRANSCENDENCE	T R AE N S EH N D AH N S
TRANSCRIPT	T R AE N S K R IH P T
TRANSFER	T R AE N S F ER
TRANSFORMATION	T R AE N S F ER M EY SH AH N
TRANSIT	T R AE N Z IH T
TRANSITION	T R AE N Z IH SH AH N
TRANSLATION	T R AE N Z L EY SH AH N
TRANSLATION(2)	T R AE N S L EY SH AH N
TRANSMISSION	T R AE N S M IH SH AH N
TRANSMISSION(2)	T R AE N Z M IH SH AH N
TRANSMUTATION	T R AE N S M Y UW T EY SH AH N
TRANSPORT	T R AE N S P AO R T
TRANSPORTATION	T R AE N S P ER T EY SH AH N
TRAP	T R AE P
TRASH	T R AE SH
TRAUMA	T R AO M AH
TRAVEL	T R AE V AH L
TRAVELER	T R AE V AH L ER
TRAVELER(2)	T R AE V L ER
TRAVELING	T R AE V AH L IH NG
TRAVELING(2)	T R AE V L IH NG
TRAVELLER	T R AE V AH L ER
TRAVELLING	T R AE V AH L IH NG
TRAVELLING(2)	T R AE V L IH NG
TRAVELS	T R AE V AH L Z
TRAY	T R EY
TREAT	T R IY T
TREATMENT	T R IY T M AH N T
TREATY	T R IY T IY
TREE	T R IY
TREND	T R EH N D
TRESS	T R EH S
TRIAGE	T R AY IH JH
TRIAL	T R AY AH L
TRIAL(2)	T R AY L
TRIBE	T R AY B
TRIBUTARY	T R IH B Y AH T EH R IY
TRICK	T R IH K
TRICKLE	T R IH K AH L
TRILLION	T R IH L Y AH N
TRIMMER	T R IH M ER
TRIO	T R IY OW
TRIP	T R IH P
TRIPLET	T R IH P L AH T
TRIVIA	T R IH V IY AH
TRIVIALITY	T R IH V IY AE L AH T IY
TROOPS	T R UW P S
TROT	T R AA T
TROTTER	T R AA T ER
TROUBLE	T R AH B AH L
TROUSERS	T R AW Z ER Z
TRUCK	T R AH K
TRUST	T R AH S T
TRUSTEE	T R AH S T IY
TRUTH	T R UW TH
TRY	T R AY
TSAR	Z AA R
TSAR(2)	T S AA R
TSUNAMI	T S UW N AA M IY
TSUNAMI(2)	S UW N AA M IY
TUB	T AH B
TUBE	T UW B
TUBE(2)	T Y UW B
TUG	T AH G
TUMOR	T UW M ER
TUNA	T UW N AH
TUNDRA	T AH N D R AH
TUNING	T UW N IH NG
TURBINE	T ER B AY N
TURKEY	T ER K IY
TURMOIL	T ER M OY L
TURN	T ER N
TURNOVER	T ER N OW V ER
TUSSOCK	T AH S AH K
TUTORIAL	T UW T AO R IY AH L
TWEEZERS	T W IY Z ER Z
TWILIGHT	T W AY L AY T
TWIN	T W IH N
TWIST	T W IH S T
TYPE	T AY P
TYPO	T AY P OW
TYRANT	T AY R AH N T
UMBRELLA	AH M B R EH L AH
UNCERTAINTY	AH N S ER T AH N T IY
UNCLE	AH NG K AH L
UNDERCURRENT	AH N D ER K ER AH N T
UNDERGRADUATE	AH N D ER G R AE JH AH W AH T
UNDERGROUND	AH N D ER G R AW N D
UNDERSTANDING	AH N D ER S T AE N D IH NG
UNDERWEAR	AH N D ER W EH R
UNDERWRITING	AH N D ER R AY T IH NG
UNEASINESS	AH N IY Z IY N AH S
UNIFORM	Y UW N AH F AO R M
UNION	Y UW N Y AH N
UNIT	Y UW N AH T
UNIT(2)	Y UW N IH T
UNITY	Y UW N AH T IY
UNITY(2)	Y UW N IH T IY
UNIVERSE	Y UW N AH V ER S
UNIVERSITY	Y UW N AH V ER S AH T IY
UNLOADING	AH N L OW D IH NG
UNWILLINGNESS	AH N W IH L IH NG N IH S
UPBRINGING	AH P B R IH NG IH NG
UPDATE	AH P D EY T
UPGRADE	AH P G R EY D
UPHEAVAL	AH P HH IY V AH L
UPLAND	AH P L AH N D
UPRISING	AH P R AY Z IH NG
URETHRA	Y ER IY TH R AH
URGE	ER JH
URGING	ER JH IH NG
URINAL	Y UH R AH N AH L
URINATION	Y UH R AH N EY SH AH N
URINE	Y ER AH N
URINE(2)	Y UH R AH N
USAGE	Y UW S AH JH
USAGE(2)	Y UW S IH JH
USE	Y UW S
USE(2)	Y UW Z
USER	Y UW Z ER
UTENSIL	Y UW T EH N S AH L
UTERINE	Y UW T ER AH N
UTILITARIANISM	Y UH T IH L AH T EH R IY AH N IH Z AH M
UTILITY	Y UW T IH L AH T IY
VACANCY	V EY K AH N S IY
VACATION	V EY K EY SH AH N
VACCINE	V AE K S IY N
VACUUM	V AE K Y UW M
VALET	V AE L EY
VALIDITY	V AH L IH D IH T IY
VALLEY	V AE L IY
VALUATION	V AE L Y UW EY SH AH N
VALUE	V AE L Y UW
VALVE	V AE L V
VAN	V AE N
VANILLA	V AH N IH L AH
VAPOR	V EY P ER
VARIETY	V ER AY AH T IY
VASTNESS	V AE S T N AH S
VEGETABLE	V EH JH T AH B AH L
VEGETARIAN	V EH JH AH T EH R IY AH N
VEGGIE	V EH JH IY
VEHICLE	V IY HH IH K AH L
VEHICLE(2)	V IY IH K AH L
VEIL	V EY L
VENDOR	V EH N D ER
VENGEANCE	V EH N JH AH N S
VENT	V EH N T
VENTILATION	V EH N T IH L EY SH AH N
VENTILATOR	V EH N T IH L EY T ER
VENTURE	V EH N CH ER
VENUE	V EH N Y UW
VERDICT	V ER D IH K T
VERSION	V ER ZH AH N
VESSEL	V EH S AH L
VEST	V EH S T
VET	V EH T
VETERAN	V EH T ER AH N
VETERAN(2)	V EH T R AH N
VETERINARIAN	V EH T R AH N EH R IY AH N
VETERINARIAN(2)	V EH T ER AH N EH R IY AH N
VETO	V IY T OW
VIABILITY	V AY AH B IH L AH T IY
VIAL	V AY AH L
VIBE	V AY B
VICE	V AY S
VICTIM	V IH K T IH M
VICTORY	V IH K T AH R IY
VIDEO	V IH D IY OW
VIDEOTAPE	V IH D IY OW T EY P
VIEW	V Y UW
VIEWER	V Y UW ER
VIEWPOINT	V Y UW P OY N T
VIEWS	V Y UW Z
VILLAGE	V IH L AH JH
VILLAGE(2)	V IH L IH JH
VINTAGE	V IH N T IH JH
VIOLATION	V AY AH L EY SH AH N
VIOLENCE	V AY AH L AH N S
VIRILITY	V ER IH L AH T IY
VIRTUOSO	V ER CH UW OW S OW
VIRUS	V AY R AH S
VISA	V IY Z AH
VISIBILITY	V IH Z AH B IH L IH T IY
VISION	V IH ZH AH N
VISIT	V IH Z IH T
VISITOR	V IH Z IH T ER
VISUALIZATION	V IH ZH W AH L AH Z EY SH AH N
VITAMIN	V AY T AH M AH N
VOCAL	V OW K AH L
VOICE	V OY S
VOID	V OY D
VOLATILITY	V AA L AH T IH L AH T IY
VOLUME	V AA L Y UW M
VOLUNTEER	V AA L AH N T IH R
VOLUNTEERING	V AO L AH N T IH R IH NG
VOMITING	V AA M AH T IH NG
VOTE	V OW T
VOTER	V OW T ER
VOTING	V OW T IH NG
VULNERABILITY	V AH L N ER AH B IH L IH T IY
WADING	W EY D IH NG
WAFFLE	W AA F AH L
WAGER	W EY JH ER
WAGON	W AE G AH N
WAIST	W EY S T
WAIT	W EY T
WAITER	W EY T ER
WAITING	W EY T IH NG
WAITRESS	W EY T R AH S
WAIVER	W EY V ER
WAKE	W EY K
WALK	W AO K
WALK(2)	W AA K
WALKING	W AO K IH NG
WALKWAY	W AO K W EY
WALL	W AO L
WALLET	W AO L AH T
WALNUT	W AO L N AH T
WANTON	W AO N T AH N
WANTON(2)	W AA N T AH N
WAR	W AO R
WARD	W AO R D
WAREHOUSE	W EH R HH AW S
WARFARE	W AO R F EH R
WARLORD	W AO R L AO R D
WARM	W AO R M
WARMING	W AO R M IH NG
WARMONGER	W AO R M AA NG G ER
WARMTH	W AO R M TH
WARNING	W AO R N IH NG
WARRANTY	W AO R AH N T IY
WARRIOR	W AO R IY ER
WARRIOR(2)	W AO R Y ER
WASH	W AA SH
WASHER	W AA SH ER
WASP	W AA S P
WASTE	W EY S T
WATCH	W AA CH
WATCH(2)	W AO CH
WATCHER	W AA CH ER
WATER	W AO T ER
WATERFALL	W AO T ER F AO L
WATERFRONT	W AO T ER F R AH N T
WATT	W AA T
WAVE	W EY V
WAX	W AE K S
WAY	W EY
WEALTH	W EH L TH
WEAPON	W EH P AH N
WEATHER	W EH DH ER
WEB	W EH B
WEBSITE	W EH B S AY T
WEDDING	W EH D IH NG
WEDGE	W EH JH
WEEK	W IY K
WEEKDAY	W IY K D EY
WEEKEND	W IY K EH N D
WEEKEND(2)	W IY K IH N D
WEIGHT	W EY T
WEIRDNESS	W IH R D N AH S
WELFARE	W EH L F EH R
WELL	W EH L
WEST	W EH S T
WHATNOT	W AH T N AA T
WHATNOT(2)	HH W AH T N AA T
WHEAT	W IY T
WHEAT(2)	HH W IY T
WHEEL	W IY L
WHEEL(2)	HH W IY L
WHEELER	W IY L ER
WHEELER(2)	HH W IY L ER
WHERE	W EH R
WHERE(2)	HH W EH R
WHEREABOUTS	W EH R AH B AW T S
WHEREABOUTS(2)	HH W EH R AH B AW T S
WHILE	W AY L
WHILE(2)	HH W AY L
WHIM	W IH M
WHIM(2)	HH W IH M
WHITE	W AY T
WHITE(2)	HH W AY T
WHITING	W AY T IH NG
WHITING(2)	HH W AY T IH NG
WHOLE	HH OW L
WIDTH	W IH D TH
WIFE	W AY F
WIGHT	W AY T
WILD	W AY L D
WILDFLOWER	W AY L D F L AW ER
WILDLIFE	W AY L D L AY F
WILE	W AY L
WILL	W IH L
WILL(2)	W AH L
WILLINGNESS	W IH L IH NG N AH S
WILLOW	W IH L OW
WIND	W AY N D
WIND(2)	W IH N D
WINDFALL	W IH N D F AO L
WINDOW	W IH N D OW
WINDOWS	W IH N D OW Z
WINE	W AY N
WING	W IH NG
WINGER	W IH NG ER
WINNER	W IH N ER
WINTER	W IH N T ER
WIRE	W AY ER
WIRE(2)	W AY R
WIRING	W AY R IH NG
WISDOM	W IH Z D AH M
WISH	W IH SH
WIT	W IH T
WITHDRAWAL	W IH DH D R AO AH L
WITHDRAWAL(2)	W IH TH D R AO AH L
WITNESS	W IH T N AH S
WOK	W AA K
WOLF	W UH L F
WOMAN	W UH M AH N
WONDER	W AH N D ER
WONDERLAND	W AH N D ER L AE N D
WOOD	W UH D
WOODPECKER	W UH D P EH K ER
WOOL	W UH L
WOOLLY	W UH L IY
WORD	W ER D
WORDING	W ER D IH NG
WORK	W ER K
WORKER	W ER K ER
WORKFORCE	W ER K F AO R S
WORKING	W ER K IH NG
WORKMANSHIP	W ER K M AH N SH IH P
WORKPLACE	W ER K P L EY S
WORKSHEET	W ER K SH IY T
WORKSHOP	W ER K SH AA P
WORLD	W ER L D
WORM	W ER M
WORRY	W ER IY
WORSHIP	W ER SH AH P
WORSHIP(2)	W ER SH IH P
WORSHIPPER	W ER SH AH P ER
WORTH	W ER TH
WOUND	W AW N D
WOUND(2)	W UW N D
WRAPPING	R AE P IH NG
WRATH	R AE TH
WRECK	R EH K
WRINKLE	R IH NG K AH L
WRITER	R AY T ER
WRITING	R AY T IH NG
WRITINGS	R AY T IH NG Z
WRONG	R AO NG
YAHOO	Y AA HH UW
YAM	Y AE M
YARD	Y AA R D
YARN	Y AA R N
YEAR	Y IH R
YELLING	Y EH L IH NG
YES	Y EH S
YESTERDAY	Y EH S T ER D EY
YESTERDAY(2)	Y EH S T ER D IY
YOGA	Y OW G AH
YOKE	Y OW K
YOU	Y UW
YOUNG	Y AH NG
YOUNGSTER	Y AH NG S T ER
YOUTH	Y UW TH
ZEALOT	Z EH L AH T
ZEALOT(2)	Z IY L AH T
ZEBRA	Z IY B R AH
ZERO	Z IY R OW
ZINC	Z IH NG K
ZONE	Z OW N
ZOO	Z UW
ZOOM	Z UW M
